받을까 말까 라마 => 받을까 말까 라마, 받을까말까라마
찬바람이 쌩쌩 내 발은 씽씽 => 찬바람이 쌩쌩 내 발은 씽씽, 찬바람이쌩쌩내발은씽씽
높고 높은 하늘 한번 보실래요 => 높고 높은 하늘 한번 보실래요, 높고높은하늘한번보실래요
포근한 케이크 같이 기대되는 => 포근한 케이크 같이 기대되는, 포근한케이크같이기대되는
꽃 향기 가득한 날 => 꽃 향기 가득한 날, 꽃향기가득한날
자유로웠던 지난 밤 꿈 같은 당신의 통화 => 자유로웠던 지난 밤 꿈 같은 당신의 통화, 자유로웠던지난밤꿈같은당신의통화
바다 위의 힐링 => 바다 위의 힐링, 바다위의힐링
전화 좀 자주해 남자편 => 전화 좀 자주해 남자편, 전화좀자주해남자편
틈새운동 따라해 보세요 여자편 => 틈새운동 따라해 보세요 여자편, 틈새운동따라해보세요여자편
피 땀 눈물 => 피 땀 눈물, 피땀눈물
펭수의 엣헴송 국악버전 => 펭수의 엣헴송 국악버전, 펭수의엣헴송국악버전
펭수의 엣헴송 => 펭수의 엣헴송, 펭수의엣헴송
펭수의 흥모먼트 => 펭수의 흥모먼트, 펭수의흥모먼트
찬열이 전하는 추석인사 => 찬열이 전하는 추석인사, 찬열이전하는추석인사
라 루나 => 라 루나, 라루나
힘내 후라이 에그링 => 힘내 후라이 에그링, 힘내후라이에그링
힘들어도 파이팅 에그링 => 힘들어도 파이팅 에그링, 힘들어도파이팅에그링
나와서 먹고갈래 라면링 => 나와서 먹고갈래 라면링, 나와서먹고갈래라면링
커피 한 잔의 여유 => 커피 한 잔의 여유, 커피한잔의여유
뮤비 메이킹 => 뮤비 메이킹, 뮤비메이킹
똥꼬발랄 점프냥 => 똥꼬발랄 점프냥, 똥꼬발랄점프냥
찜통 더위 기념 삼색이 눈밭영상 => 찜통 더위 기념 삼색이 눈밭영상, 찜통더위기념삼색이눈밭영상
행성 우다다다다 => 행성 우다다다다, 행성우다다다다
아재퀴즈 대학생이 싫어하는 강 => 아재퀴즈 대학생이 싫어하는 강, 아재퀴즈대학생이싫어하는강
난 일해 => 난 일해, 난일해
5시 53분의 하늘에서 발견한 너와 나 => 5시 53분의 하늘에서 발견한 너와 나, 5시53분의하늘에서발견한너와나
슬기의 착붙으링 => 슬기의 착붙으링, 슬기의착붙으링
아이린의 착붙으링 => 아이린의 착붙으링, 아이린의착붙으링
예리의 착붙으링 => 예리의 착붙으링, 예리의착붙으링
조이의 착붙으링 => 조이의 착붙으링, 조이의착붙으링
잘 자 => 잘 자, 잘자
아무 걱정 하지마 => 아무 걱정 하지마, 아무걱정하지마
끊음 안돼 산타 워킹 => 끊음 안돼 산타 워킹, 끊음안돼산타워킹
새해 복 받으소 => 새해 복 받으소, 새해복받으소
새해 빙인사 => 새해 빙인사, 새해빙인사
김연아의 복많이받으링 => 김연아의 복많이받으링, 김연아의복많이받으링
레드벨벳의 새해복받으링 => 레드벨벳의 새해복받으링, 레드벨벳의새해복받으링
박지훈의 애교링 => 박지훈의 애교링, 박지훈의애교링
연애혁명 이경우의 비주얼링 => 연애혁명 이경우의 비주얼링, 연애혁명이경우의비주얼링
왕공커플 결계허그 => 왕공커플 결계허그, 왕공커플결계허그
아직도 그대로인 건 => 아직도 그대로인 건, 아직도그대로인건
내 안엔 그대가 살아 => 내 안엔 그대가 살아, 내안엔그대가살아
달빛 별 => 달빛 별, 달빛별
은우의 천만 세배 => 은우의 천만 세배, 은우의천만세배
Ur So F**kInG cOoL => Ur So F**kInG cOoL, UrSoF**kInGcOoL
에비츄 설레여츄 => 에비츄 설레여츄, 에비츄설레여츄
새해 복 많이 받으시츄 => 새해 복 많이 받으시츄, 새해복많이받으시츄
라이너스의 담요 => 라이너스의 담요, 라이너스의담요
블루 서클 루프 => 블루 서클 루프, 블루서클루프
하트 로딩 => 하트 로딩, 하트로딩
파스텔핑크 로딩 => 파스텔핑크 로딩, 파스텔핑크로딩
블랙핑크 로딩 => 블랙핑크 로딩, 블랙핑크로딩
레트로 카세프 테이프 => 레트로 카세프 테이프, 레트로카세프테이프
더 더 => 더 더, 더더
내 방 => 내 방, 내방
내게도 색이 칠해진다면 좋겠어 => 내게도 색이 칠해진다면 좋겠어, 내게도색이칠해진다면좋겠어
그 해 이야기 => 그 해 이야기, 그해이야기
사랑을 한 번 할 수 있다면 => 사랑을 한 번 할 수 있다면, 사랑을한번할수있다면
새해 복 => 새해 복, 새해복
그 때 => 그 때, 그때
몬스타엑스 셔누와 밀당하링 => 몬스타엑스 셔누와 밀당하링, 몬스타엑스셔누와밀당하링
몬스타엑스 형원 도전하링 => 몬스타엑스 형원 도전하링, 몬스타엑스형원도전하링
킬링벌스 한해 => 킬링벌스 한해, 킬링벌스한해
한해의 무반주벌스 => 한해의 무반주벌스, 한해의무반주벌스
타임랩스 살구 꽃 => 타임랩스 살구 꽃, 타임랩스살구꽃
별 시 => 별 시, 별시
정세운 받을까말까링 => 정세운 받을까말까링, 정세운받을까말까링
너랑 나 => 너랑 나, 너랑나
숨은 연아 찾으링 => 숨은 연아 찾으링, 숨은연아찾으링
야 우냐 => 야 우냐, 야우냐
별과 해 => 별과 해, 별과해
처음부터 너와 나 => 처음부터 너와 나, 처음부터너와나
박명수의 추석맞이 댄스 타임 => 박명수의 추석맞이 댄스 타임, 박명수의추석맞이댄스타임
정태호의 발렌타인 데이 선물 => 정태호의 발렌타인 데이 선물, 정태호의발렌타인데이선물
새해 복 많이 받으세요 => 새해 복 많이 받으세요, 새해복많이받으세요
금전운 부적 => 금전운 부적, 금전운부적
연애운 부적 => 연애운 부적, 연애운부적
스노보드 턴 => 스노보드 턴, 스노보드턴
강 위를 떠나는 구름 => 강 위를 떠나는 구름, 강위를떠나는구름
사랑해 너님 => 사랑해 너님, 사랑해너님
바다 위 완벽한 쉼터 => 바다 위 완벽한 쉼터, 바다위완벽한쉼터
워크맨 노동요 제작기 => 워크맨 노동요 제작기, 워크맨노동요제작기
우주소녀 엑시 내 소개하링 => 우주소녀 엑시 내 소개하링, 우주소녀엑시내소개하링
우주소녀 수빈 흥치치뿡링 => 우주소녀 수빈 흥치치뿡링, 우주소녀수빈흥치치뿡링
힐링타임 커피레옹 => 힐링타임 커피레옹, 힐링타임커피레옹
새해 복 많이 받으소 => 새해 복 많이 받으소, 새해복많이받으소
퓨쳐리즘 레트로 드라이브 => 퓨쳐리즘 레트로 드라이브, 퓨쳐리즘레트로드라이브
블루 문라이트 드라이브 => 블루 문라이트 드라이브, 블루문라이트드라이브
컬러풀 트랜지션 => 컬러풀 트랜지션, 컬러풀트랜지션
내 손을 잡아 => 내 손을 잡아, 내손을잡아
내 생에 아름다운 => 내 생에 아름다운, 내생에아름다운
이러지마 제발 => 이러지마 제발, 이러지마제발
임플란티드 키드 => 임플란티드 키드, 임플란티드키드
큰지의 갑분숨 => 큰지의 갑분숨, 큰지의갑분숨
틀린그림찾기 집콕 => 틀린그림찾기 집콕, 틀린그림찾기집콕
확찐자 운동 => 확찐자 운동, 확찐자운동
코코몽 로보콩 출동 => 코코몽 로보콩 출동, 코코몽로보콩출동
무한도전 거성체조 => 무한도전 거성체조, 무한도전거성체조
무한도전 명수대침공 => 무한도전 명수대침공, 무한도전명수대침공
무한도전 무한상사 => 무한도전 무한상사, 무한도전무한상사
무한도전 치명수 => 무한도전 치명수, 무한도전치명수
벚꽃 엔딩 => 벚꽃 엔딩, 벚꽃엔딩
십이월 이십오일의 고백 => 십이월 이십오일의 고백, 십이월이십오일의고백
시가 될 이야기 => 시가 될 이야기, 시가될이야기
편지를 놓아 둘게요 => 편지를 놓아 둘게요, 편지를놓아둘게요
리듬 타 => 리듬 타, 리듬타
모 아님 도 => 모 아님 도, 모아님도
전화 받으세요 용사여 => 전화 받으세요 용사여, 전화받으세요용사여
외딴 섬 => 외딴 섬, 외딴섬
아이컨택 기린링 => 아이컨택 기린링, 아이컨택기린링
쿼카 먹방링 => 쿼카 먹방링, 쿼카먹방링
킬링벌스 치타 => 킬링벌스 치타, 킬링벌스치타
킬링벌스 릴보이 => 킬링벌스 릴보이, 킬링벌스릴보이
킬링벌스 릴보이 기도 => 킬링벌스 릴보이 기도, 킬링벌스릴보이기도
줍깅 캠패인 => 줍깅 캠패인, 줍깅캠패인
빅 벤 => 빅 벤, 빅벤
포 린 사원 => 포 린 사원, 포린사원
호르세쇼 밴드 => 호르세쇼 밴드, 호르세쇼밴드
집순이는 늘 짜릿해 => 집순이는 늘 짜릿해, 집순이는늘짜릿해
홍대 앞 => 홍대 앞, 홍대앞
푸른 봄 하늘에 벚꽃 한다발 => 푸른 봄 하늘에 벚꽃 한다발, 푸른봄하늘에벚꽃한다발
물레방아 도는데 => 물레방아 도는데, 물레방아도는데
반대로 인 거야 => 반대로 인 거야, 반대로인거야
너에게로 또 다시 => 너에게로 또 다시, 너에게로또다시
조심 조심 강아지 => 조심 조심 강아지, 조심조심강아지
괜찮아 니 잘못이 아니야 => 괜찮아 니 잘못이 아니야, 괜찮아니잘못이아니야
당신의 편이 되어 줄게요 => 당신의 편이 되어 줄게요, 당신의편이되어줄게요
바비 자켓 메이킹 => 바비 자켓 메이킹, 바비자켓메이킹
인생 라면 => 인생 라면, 인생라면
feat. Jhené Aiko => feat. Jhené Aiko, feat.JhenéAiko
사는게 다 => 사는게 다, 사는게다
쾌지나 칭칭 나네 => 쾌지나 칭칭 나네, 쾌지나칭칭나네
빠져든다 하트 뿅뿅 => 빠져든다 하트 뿅뿅, 빠져든다하트뿅뿅
레트로 컬러풀 큐브 => 레트로 컬러풀 큐브, 레트로컬러풀큐브
넌센스 퀴즈 => 넌센스 퀴즈, 넌센스퀴즈
연인과 함께 별 헤는 밤 => 연인과 함께 별 헤는 밤, 연인과함께별헤는밤
왕 부담 개눈빛 => 왕 부담 개눈빛, 왕부담개눈빛
제이는 그루밍중 => 제이는 그루밍중, 제이는그루밍중
이제는 줍깅하다 => 이제는 줍깅하다, 이제는줍깅하다
저 달 => 저 달, 저달
그대가 내 안에 박혔다 => 그대가 내 안에 박혔다, 그대가내안에박혔다
남이 될 수 있을까 => 남이 될 수 있을까, 남이될수있을까
구르미 그린 달빛 => 구르미 그린 달빛, 구르미그린달빛
천재견 사월이 개인기 => 천재견 사월이 개인기, 천재견사월이개인기
여름 한 조각 => 여름 한 조각, 여름한조각
내 사랑 내 곁에 => 내 사랑 내 곁에, 내사랑내곁에
아야해 아야 => 아야해 아야, 아야해아야
한 잔의 여유 괜찮죠 => 한 잔의 여유 괜찮죠, 한잔의여유괜찮죠
장화 신은 고양이 => 장화 신은 고양이, 장화신은고양이
몬스타엑스 형원 패션필름 => 몬스타엑스 형원 패션필름, 몬스타엑스형원패션필름
몬스타엑스 셔누 패션필름 => 몬스타엑스 셔누 패션필름, 몬스타엑스셔누패션필름
긴 긴 인사 => 긴 긴 인사, 긴긴인사
넌 내 안에 => 넌 내 안에, 넌내안에
성수로 와 => 성수로 와, 성수로와
드라이브 하며 즐기는 시티팝 => 드라이브 하며 즐기는 시티팝, 드라이브하며즐기는시티팝
더 많이 사랑한 쪽이 아프대 => 더 많이 사랑한 쪽이 아프대, 더많이사랑한쪽이아프대
헬프미 큐핏 => 헬프미 큐핏, 헬프미큐핏
우산 같이 쓸까요 => 우산 같이 쓸까요, 우산같이쓸까요
100초로 보는 아스트로 니가 불어와 => 100초로 보는 아스트로 니가 불어와, 100초로보는아스트로니가불어와
아스트로 도전하링 => 아스트로 도전하링, 아스트로도전하링
디비디비딥 주방랩 => 디비디비딥 주방랩, 디비디비딥주방랩
함정우의 해피 길모어샷 => 함정우의 해피 길모어샷, 함정우의해피길모어샷
룰루랄라 웅 직캠 => 룰루랄라 웅 직캠, 룰루랄라웅직캠
룰루랄라 동현 직캠 => 룰루랄라 동현 직캠, 룰루랄라동현직캠
룰루랄라 우진 직캠 => 룰루랄라 우진 직캠, 룰루랄라우진직캠
룰루랄라 대휘 직캠 => 룰루랄라 대휘 직캠, 룰루랄라대휘직캠
한 판 뜨자 => 한 판 뜨자, 한판뜨자
귤 마시쪙 => 귤 마시쪙, 귤마시쪙
장 보러 가는 날 => 장 보러 가는 날, 장보러가는날
서핑하는 윌벤져스 => 서핑하는 윌벤져스, 서핑하는윌벤져스
귀염뽀작 건후 => 귀염뽀작 건후, 귀염뽀작건후
수타 건후 => 수타 건후, 수타건후
장프랑수아 밀레의 이삭 줍는 여인들 => 장프랑수아 밀레의 이삭 줍는 여인들, 장프랑수아밀레의이삭줍는여인들
오마이걸의 틀린그림찾으링 => 오마이걸의 틀린그림찾으링, 오마이걸의틀린그림찾으링
오마이걸의 숨은그림찾으링 => 오마이걸의 숨은그림찾으링, 오마이걸의숨은그림찾으링
나 왔는데…아무도없어요 => 나 왔는데…아무도없어요, 나왔는데…아무도없어요
데헷 츄 => 데헷 츄, 데헷츄
판 수영장 휴가 => 판 수영장 휴가, 판수영장휴가
시인 할머니의 거짓 않는 자연 황보출 시인 => 시인 할머니의 거짓 않는 자연 황보출 시인, 시인할머니의거짓않는자연황보출시인
마마무 도전하링 => 마마무 도전하링, 마마무도전하링
행복한 추석 되시길 => 행복한 추석 되시길, 행복한추석되시길
철길만 남은 잊혀진 폐역 => 철길만 남은 잊혀진 폐역, 철길만남은잊혀진폐역
달하 노피곰 도다샤 => 달하 노피곰 도다샤, 달하노피곰도다샤
우주소녀 루다 썸머필름 => 우주소녀 루다 썸머필름, 우주소녀루다썸머필름
너의 걱정을 씻어줄 비 => 너의 걱정을 씻어줄 비, 너의걱정을씻어줄비
스케이트 보드 => 스케이트 보드, 스케이트보드
붐 치키 => 붐 치키, 붐치키
손이 가 => 손이 가, 손이가
뿌요 뿌요 => 뿌요 뿌요, 뿌요뿌요
니가 없이도 난 잘 지내 => 니가 없이도 난 잘 지내, 니가없이도난잘지내
이 사랑 => 이 사랑, 이사랑
올려주는 첫 마디 => 올려주는 첫 마디, 올려주는첫마디
re;code Episode Ⅷ => re;code Episode Ⅷ, re;codeEpisodeⅧ
우리 만남이 => 우리 만남이, 우리만남이
Tiësto Remix => Tiësto Remix, TiëstoRemix
삐뽀삐뽀 구급차 => 삐뽀삐뽀 구급차, 삐뽀삐뽀구급차
뽀로로와 루피의 모험 엔딩곡 => 뽀로로와 루피의 모험 엔딩곡, 뽀로로와루피의모험엔딩곡
나 그대의 바람 되어 - 노이 테마 => 나 그대의 바람 되어 - 노이 테마, 나그대의바람되어-노이테마
지하철 소음송 => 지하철 소음송, 지하철소음송
싱싱머신링 정홍일 => 싱싱머신링 정홍일, 싱싱머신링정홍일
킬링보이스 백지영 총맞은 것처럼 => 킬링보이스 백지영 총맞은 것처럼, 킬링보이스백지영총맞은것처럼
째깍 째깍 째깍 => 째깍 째깍 째깍, 째깍째깍째깍
그 날 => 그 날, 그날
스트레스 제로 => 스트레스 제로, 스트레스제로
칵테일과 함께 즐거운 호캉스 => 칵테일과 함께 즐거운 호캉스, 칵테일과함께즐거운호캉스
윤슬 속으로 다이빙 하는 연인 => 윤슬 속으로 다이빙 하는 연인, 윤슬속으로다이빙하는연인
니가 사는 그 집 => 니가 사는 그 집, 니가사는그집
시원함 만끽하고 계세요 => 시원함 만끽하고 계세요, 시원함만끽하고계세요
풍성한 한가위 되세요 => 풍성한 한가위 되세요, 풍성한한가위되세요
뜨거운 감자 => 뜨거운 감자, 뜨거운감자
은근히 낯가려요 => 은근히 낯가려요, 은근히낯가려요
척롤 파 소금구이편 => 척롤 파 소금구이편, 척롤파소금구이편
얀 반 에이크의 아르놀피니 부부의 초상화 => 얀 반 에이크의 아르놀피니 부부의 초상화, 얀반에이크의아르놀피니부부의초상화
조르주 피에르 쇠라의 그랑드 자트 섬의 일요일 오후 => 조르주 피에르 쇠라의 그랑드 자트 섬의 일요일 오후, 조르주피에르쇠라의그랑드자트섬의일요일오후
앙리 마티스의 붉은 색의 조화 => 앙리 마티스의 붉은 색의 조화, 앙리마티스의붉은색의조화
앙리 마티스의 루마니아 풍의 블라우스를 입은 여인 => 앙리 마티스의 루마니아 풍의 블라우스를 입은 여인, 앙리마티스의루마니아풍의블라우스를입은여인
오마이걸의 널뛰링 => 오마이걸의 널뛰링, 오마이걸의널뛰링
너와 나 => 너와 나, 너와나
개박사 정원석 => 개박사 정원석, 개박사정원석
집순이 모죠가 전화 받지 못하는 이유 => 집순이 모죠가 전화 받지 못하는 이유, 집순이모죠가전화받지못하는이유
아 집가고 싶다 => 아 집가고 싶다, 아집가고싶다
그 곳에 서서 => 그 곳에 서서, 그곳에서서
한 번 더 자기 자리를 뒤돌아보자 => 한 번 더 자기 자리를 뒤돌아보자, 한번더자기자리를뒤돌아보자
트러블 메이커 => 트러블 메이커, 트러블메이커
사랑이 고프다 => 사랑이 고프다, 사랑이고프다
끝까지 안아 줄게 => 끝까지 안아 줄게, 끝까지안아줄게
가을 커피 한 잔 => 가을 커피 한 잔, 가을커피한잔
인생은 라랄라 => 인생은 라랄라, 인생은라랄라
언젠가 너와 나 => 언젠가 너와 나, 언젠가너와나
뮤비 메이킹 필름 => 뮤비 메이킹 필름, 뮤비메이킹필름
저녁 같이 드실래요 => 저녁 같이 드실래요, 저녁같이드실래요
킬링벌스 그레이 하기나 해 => 킬링벌스 그레이 하기나 해, 킬링벌스그레이하기나해
킬링벌스 그레이 => 킬링벌스 그레이, 킬링벌스그레이
그대와 나 => 그대와 나, 그대와나
자켓 메이킹 필름 => 자켓 메이킹 필름, 자켓메이킹필름
그날 그밤 => 그날 그밤, 그날그밤
두밧두 와리와리 => 두밧두 와리와리, 두밧두와리와리
나는 문제 없어 => 나는 문제 없어, 나는문제없어
비 오는 거리에서 춤을 추자 => 비 오는 거리에서 춤을 추자, 비오는거리에서춤을추자
너와 나는 이제 남이니까 => 너와 나는 이제 남이니까, 너와나는이제남이니까
킬링보이스 넬 기억을 걷는 시간 => 킬링보이스 넬 기억을 걷는 시간, 킬링보이스넬기억을걷는시간
킬링보이스 넬 지구가 태양을 네 번 => 킬링보이스 넬 지구가 태양을 네 번, 킬링보이스넬지구가태양을네번
킬링보이스 넬 마음을 잃다 => 킬링보이스 넬 마음을 잃다, 킬링보이스넬마음을잃다
킬링보이스 넬 위로 危路 => 킬링보이스 넬 위로 危路, 킬링보이스넬위로危路
에비츄를 따르시츄 => 에비츄를 따르시츄, 에비츄를따르시츄
군꼬와 군바미의 => 군꼬와 군바미의, 군꼬와군바미의
군꼬와 군바미의 씐나씐나 => 군꼬와 군바미의 씐나씐나, 군꼬와군바미의씐나씐나
군꼬와 군바미 => 군꼬와 군바미, 군꼬와군바미
내가 날 버린 이유 => 내가 날 버린 이유, 내가날버린이유
사랑 하나면 돼 => 사랑 하나면 돼, 사랑하나면돼
죽고 싶단 말 밖에 => 죽고 싶단 말 밖에, 죽고싶단말밖에
잘자 내 몫까지 => 잘자 내 몫까지, 잘자내몫까지
너만 들음 돼 => 너만 들음 돼, 너만들음돼
베놈2 렛 데어 비 카니지 => 베놈2 렛 데어 비 카니지, 베놈2렛데어비카니지
모니카 & 립제이 댄스 => 모니카 & 립제이 댄스, 모니카&립제이댄스
가을 핑크뮬리 한송이 => 가을 핑크뮬리 한송이, 가을핑크뮬리한송이
가을 코스모스 한송이 => 가을 코스모스 한송이, 가을코스모스한송이
미스 김 => 미스 김, 미스김
핫초코 마쉬멜로우 => 핫초코 마쉬멜로우, 핫초코마쉬멜로우
일분 일초 => 일분 일초, 일분일초
유형 별 전화를 받지 않는 이유 => 유형 별 전화를 받지 않는 이유, 유형별전화를받지않는이유
& => &,앤드,앤,and
@ my worst => 앳마이워스트,@ my worst,@myworst,앳 마이 워스트
015B => 015B,공일오비
0X1=LOVESONG => 0X1=LOVESONG,제로바이원러브송
10cm => 10cm,십센치,10센치
12月 => 12月,12월
19XX => 19XX,19엑스엑스
1TEAM => 1TEAM,원팀
1THE9 => 1THE9,원더나인
24KGoldn => 24KGoldn,24케이골든
2am => 2am 투에이엠,투에이앰
2BIC => 2BIC,투빅
2easy => 2easy,투이지
2FACE => 2FACE,투페이스
2LSON => 에일리,AILEE,2LSON,투엘슨
2PM => 2PM,투피엠
2U => 2U,투유
3!4! => 3!4!,쓰리포
30 Sexy => 30 Sexy,30Sexy,써티섹시,써티 섹시
347aidan => 347aidan,347에이단
3M => 3M,쓰리엠
3SCAPE => 3SCAPE,쓰리 스케입,쓰리스케입
5 Seconds Of Summer => 5 Seconds Of Summer,5SecondsOfSummer,5 세컨즈 오브 서머,5세컨즈오브서머
6 crazy => 6 crazy,6crazy,SIXC,식스 크레이지,식스크레이지
6LACK => 6LACK,블랙
88rising => 88rising,88라이징
9-TEEN => 나인틴,nineteen,9teen
A$AP Ferg => A$AP Ferg,A$APFerg,에이셉 퍼그,에이셉퍼그
A.C.E => A.C.E,ACE,에이스
A.D.H.D => A.D.H.D,ADHD,에이디에이치디
A.M. => A.M.,에이엠
ABNEW => ABNEW,에비뉴,AB6IX,에이비식스
About => About,어바웃
AboutU => AboutU,어바우츄
AC/DC => AC/DC,ACDC,에이씨 디씨,에이씨디씨
Acapulco => Acapulco,아카풀코
acid => acid,에시드,애시드
across => across,어크로스
Adam Lambert => Adam Lambert,AdamLambert,아담 램버트,아담램버트
Adele => Adele,아델
Adios => Adios,아디오스
adore => adore,어도어
ADOY => ADOY,아도이
adults => adults,어덜츠
Advice => Advice,어드바이스
aespa => aespa,에스파
Affair => Affair,어페어
After => After,애프터,에프터
afterglow => afterglow,애프터글로우,에프터글로우
Afterimage => Afterimage,애프터이미지
Afterlife => Afterlife,애프터라이프
Afternoon => Afternoon,에프터눈,애프터눈
AfterSchool => AfterSchool,애프터스쿨
again => again,어게인,어겐
AH => AH,아
AH YEAH => AH YEAH,아예
Ah-Choo => Ah-Choo,아추,아츄
Ahrix => Ahrix,아릭스
Ain't => Ain't,에인트
air => air,에어
AIRPLANE => AIRPLANE,에어플래인
AJ => AJ,에이제이
AJ Mitchell => AJ Mitchell,AJMitchell,에이제이 미첼,에이제이미첼
AJR => AJR,에이제이알
Alan Walker => Alan Walker,AlanWalker,알렌 워커,알렌워커
Alcohol-Free => Alcohol-Free,AlcoholFree,알코올프리,알콜프리
Alec Benjamin => Alec Benjamin,AlecBenjamin,알렉 벤자민,알렉벤자민
ALEPH => ALEPH,알레프
Alessia Cara => Alessia Cara,AlessiaCara,알렉시아 카라,알렉시아카라
Alexander 23 => Alexander 23,Alexander23,알렉산더 23,알렉산더23
Ali Gatie => Ali Gatie,AliGatie,알리 게티,알리게티
ALIEN => ALIEN,에일리언
Align => Align,얼라인
alive => alive,얼라이브
ALL => ALL,올
Alligator => Alligator,앨리게이터
Alone => Alone,얼론,어론
Alright => Alright,올라잇
ALWAYS => ALWAYS,올웨이즈
Amazing => Amazing,어메이징
Aminé => Aminé,Amine,아미네
Amir => Amir,아미르
analog => analog,아날로그
Andern Kid => Andern Kid,AndernKid,앤던 키드,앤던키드
Anderson .Paak => Anderson .Paak,AndersonPaak,앤더슨 팩,앤더슨팩
Andy Grammer => Andy Grammer,AndyGrammer,앤디 그래머,앤디그래머
Angel => Angel,엔젤
Angèle => Angèle,Angele,앙젤,앙엘
angels => angels,엔젤스
angel's => angel's,엔젤스
animuk => animuk,애니먹
Anne-Marie => Anne-Marie,AnneMarie,앤 마리,앤마리
Anniversary => Anniversary,애니버서리,에니버서리
annoying => annoying,어노잉
Another => Another,어나더
Answer => Answer,앤서
Ant Saunders => Ant Saunders,AntSaunders,앤트 사운더스,앤트사운더스
ANTI => ANTI,안티
Anticlimax => Anticlimax,안티클라이맥스,안티클라이막스
Antidote => Antidote,안티도트
Antifreeze => Antifreeze,안티프리즈
antigravity => antigravity,안티그래비티
Antihero => Antihero,안티히어로
Antisocial => Antisocial,안티소셜
Anxiety => Anxiety,앵자이어티
Anxious => Anxious,앵셔스
Anycall => Anycall,애니콜
anymore => anymore,애니모어
Anyone => Anyone,애니원
Anything => Anything,애니띵,애니씽
anytime => anytime,애니타임
anywhere => anywhere,애니웨어
AOA => AOA,에이오에이
apartment => apartment,아파트먼트
APOKI => APOKI,아뽀키,아포키
Apollo => Apollo,아폴로
Apple => Apple,애플
APRIL => APRIL,에이프릴
APRO => APRO,아프로
Arcade => Arcade,아케이드
Ariana Grande => Ariana Grande,Ariana Grande,아리아나 그란데,아리아나그란데
Ariel => Ariel,아리엘
Aries => Aries,에리즈
Arin Ray => Arin Ray,ArinRay,아린 레이,아린레이
Around => Around,어라운드
arrow => arrow,애로우
ART => ART,아트
Artist => Artist,아티스트
ASAP => ASAP,as soon as possible,아삽
ASH ISLAND => ASH ISLAND,ASHISLAND,애쉬 아일랜드,애쉬아일랜드
ashby => ashby,애쉬비,애시비
Ashley => Ashley,애슐리
Ashnikko => Ashnikko,아시니코
ASTRO => ASTRO,아스트로
Astronaut => Astronaut,애스트로넛,아스트로넛
Astronomy => Astronomy,아스트로노미
Atlantis => Atlantis,아틀란티스
ATO6 => ATO6,에이투식스
attack => attack,어택
attitude => attitude,애티튜드
Au/Ra => Au/Ra,AuRa,오라,아우라
Audrey Mika => Audrey Mika,AudreyMika,오드리 미카,오드리미카
AUDREY NUNA => AUDREY NUNA,AUDREYNUNA,오드리 누나,오드리누나
AUTOMATA => AUTOMATA,오토마타
autopilot => autopilot,오토파일럿
Autumn => Autumn,어텀,오톰
Ava Max => Ava Max,AvaMax,에이바 맥스,에이바맥스
Available => Available,어베일러블
Avalanche => Avalanche,아발란체
AVENUE => AVENUE,에비뉴
Awa => Awa,아와
Away => Away,어웨이
AYA => AYA,아야
ayokay => ayokay,에이요케이
b!ni => b!ni,비니
B.A.D => B.A.D,BAD,배드
B.L.E => B.L.E,BLE,비엘이
B1A4 => B1A4,비원에이포
BAAM => BAAM,뱀
baby => baby,베이비
Baby Keem => Baby Keem,BabyKeem,베이비킴,베이비 킴
BACK => BACK,백
Backyard => Backyard,백야드
Bacteria => Bacteria,박테리아
bad => bad,배드
Bad Bunny => Bad Bunny,BadBunny,배드 버니,배드버니
Badly => Badly,배들리
BAEKHYUN => BAEKHYUN,백현,EXO,엑소
BaekZYoung => BaekZYoung,백지영
Bahari => Bahari,바하리
Ballet => Dark Ballet,DarkBallet,다크 발레,다크발레
Balloon => Balloon,벌룬
BamBam => BamBam,뱀뱀
Bambi => Bambi,밤비
Bandage => Bandage,밴디지
bandit => bandit,밴디트,밴딧
Banx => Banx,방크스
Banx & Ranx => Banx & Ranx,Banx&Ranx,뱅스 앤 랭스,뱅스앤랭스
Barment => Barment,바먼트
Baseball => Baseball,베이스볼
Basick => Basick,베이식
Bastille => Bastille,바스틸
Bawling => Bawling,볼링
BAZOOKA! => BAZOOKA!,bazooka,바주카
Bazzi => Bazzi,바지
Bbno$ => Bbno$,베이비노머니,베이비 노 머니
BBQ => BBQ,비비큐,바비큐
BDC => BDC,비디씨
BE => BE,비
beach => beach,비치
beam => beam,빔
bear => bear,베어
Beast => Beast,비스트
beat => beat,비트
Beautiful => Beautiful,뷰티풀,뷰리풀
BEAUTY BOX => BEAUTY BOX,BEAUTYBOX,뷰티 박스,뷰티박스
Bebe Rexha => Bebe Rexha,BebeRexha,비비 렉사,비비렉사
Because => Because,비커즈,비코즈
Becky G => Becky G,BeckyG,베키지,베키 지
Becky Hill => Becky Hill,BeckyHill,베키 힐,베키힐
bed => bed,베드
BEE => BEE,비
Beenzino => Beenzino,빈지노
Beethoven => Beethoven,베토멘
before => before,비포
Behaviour => Behaviour,비헤이비어
Belief => Belief,빌리프
Believe => Believe,빌리브
Belong => Belong,빌롱,비롱
BENCH => BENCH,벤치
BenchWeLeo => BenchWeLeo,벤치위레오
Benny Blanco => Benny Blanco,BennyBlanco,베니 블랑코,베니블랑코
Benzamin => Benzamin,벤자민
BERMUDA => BERMUDA,버뮤다
Berry Good => Berry Good,Berry Good,베리 굿,베리굿
Best => Best,베스트
BESTie => BESTie,베스티
Better => Better,베터,베러
Beyoncé => Beyoncé,Beyonce,비욘세
Bicycle => Bicycle,바이스클,바이시클
Billboard => Billboard,빌보드
Billie Eilish => Billie Eilish,BillieEilish,빌리 엘리시,빌리엘리시,빌리 엘리쉬,빌리엘리쉬
Billy Poco => Billy Poco,BillyPoco,빌리 포코,빌리포코
bimil:ier => bimil:ier,bimilier,비밀리에
Bipolar => Bipolar,바이폴라
Bird => Bird,버드,벌드
Birds => Birds,벌즈,버즈
Birdy => Birdy,버디
BIRTHDAY => BIRTHDAY,벌스데이,벌쓰데이,버스데이,버쓰데이
bit => bit,비트,빗
bitch => bitch,비치
Bittersweet => Bittersweet,비터스위트,비터스윗
black => black,블랙
Black Eyed Peas => Black Eyed Peas,BlackEyedPeas,블랙 아이드 피스,블랙아이드피스
blackbear => blackbear,black bear,블랙 베어,블랙베어
BLACKPINK => BLACKPINK,블랙핑크
BLAME => BLAME,블래임,블레임
blanc => blanc,블랑
Blanket => Blanket,블랭킷
Bleed  => Bleed,블리드
bless => bless,블레스
BLESSED => BLESSED,블레스드
blind => blind,블라인드
BLITZERS => BLITZERS,블리처스
Block B => Block B,BlockB,블락 비,블락비
BLOO => BLOO,블루
Blood => Blood,블러드
Blooded => Blooded,블러디드
bloom => bloom,블룸
blossom => blossom,블라섬,블라썸,블로섬,블로썸
BLOW => BLOW,블로우
blue => blue,블루
blueberries => blueberries,블루베리스
Blueming => Blueming,블루밍
Blues => Blues,블루스
Blurry => Blurry,블러리
Boat => Boat,보트
Bob Marley => Bob Marley,BobMarley,밥 말리,밥말리
BOBBY => BOBBY,바비
BOCA => BOCA,보카,보까
Body => Body,바디,보디
BOGUMMY => BOGUMMY,보거미,박보검
Bohemian Rhapsody => Bohemian Rhapsody,BohemianRhapsody,보헤미안 랩소디,보헤미안랩소디
bomb => bomb,밤
Bon Voyage => Bon Voyage,BonVoyage,본 보야지,본보야지
Bonnie & Clyde => Bonnie & Clyde,Bonnie&Clyde,보니앤클라이드,보니 앤 클라이드
Boogie => Boogie,부기
boom => boom,붐
border => border,보더
Borest => Borest,보레스트
born => born,본
BOSS => BOSS,보스
Bottled => Bottled,보틀드
Bounces => Bounces,바운스
BOUNCY => BOUNCY,바운시
box => box,박스
BOY => Boy,보이
Boy In Space => Boy In Space,BoyInSpace,보이 인 스페이스,보이인스페이스
BOYHOOD => BOYHOOD,보이후드
BOYSHIT => BOYSHIT,보이쉿
boyz => boyz,boys,보이즈,보이스
Boyz II Men => Boyz II Men,BoyzIIMen,보이즈 투 맨,보이즈투맨
BPLIVE => 블랙핑크라이브
BRAIN => BRAIN,브레인
brave => brave,브레이브
Bravo => Bravo,브라보
break => break,브레이크
Breakdown => Breakdown,브레이크다운
Breaking => Breaking,브레이킹
breath => breath,브레스,브레쓰
BREATHE => BREATHE,브리드
Breeze => Breeze,브리즈
Brett Eldredge => Brett Eldredge,BrettEldredge,브렛 엘드리지,브렛엘드리지
Brick => Brick,브릭
broke => broke,브로크
Broken => Broken,브로큰
Bronze => Bronze,브론즈
BRUNCH => BRUNCH,브런치
Bruno Champman => Bruno Champman,BrunoChampman,브루노 챔프맨,브루노챔프맨
Bruno Mars => Bruno Mars,BrunoMars,브루노 마스,브루노마스
Bruno Martini => Bruno Martini,BrunoMartini,브루노 마티니,브루노마티니
Brush => Brush,브러쉬,브러시
Bryson Tiller => Bryson Tiller,BrysonTiller,브라이슨 틸러,브라이슨틸러
Btfl Mind => Btfl Mind,BtflMind,뷰티풀마인드,뷰티풀 마인드
BTOB => BTOB,비투비
BTOB 4U => BTOB 4U,BTOB4U,비투비 포유,비투비포유
Bubble Pop! => Bubble Pop!,BubblePop,버블 팝,버블팝
BUFFALO => BUFFALO,버팔로
Buffet => Buffet,뷔페,부페
bugAboo => bugAboo,부가부
BULLET => BULLET,불렛,불릿
Bulletproof => Bulletproof,불렛프루프
bump => bump,범프
Busy Tone => Busy Tone,BusyTone,비지 톤,비지톤
Butter => Butter,버터
Butterflies => Butterflies,버터플라이즈
BUTTERFLY => BUTTERFLY,버터플라이
Buzzkill => Buzzkill,버즈킬
By => By,바이
bye => bye,바이
BZ-BOYS (청공소년) => BZ-BOYS,BZBoys,비지보이스,청공소년,청공 소년
CA$H KiD => CA$H KiD,CASHKiD,캐시 키드,캐시키드
Cadillac => Cadillac,캐딜락
Caffeine => Caffeine,카페인
Cake => Cake,케이크
CAL => CAL,칼
California => California,캘리포니아
call => call,콜
calling => calling,콜링
Calm => Calm,캄
Calvin Harris => Calvin Harris,CalvinHarris,켈빈 해리스,켈빈해리스
CAMERAS => CAMERAS,카메라스
Camila Cabello => Camila Cabello,CamilaCabello,카밀라 카베요,카밀라카베요
Can => Can,캔
CANDO => CANDO,캔도
candy => candy,캔디
cane => cane,케인
Cannons => Cannons,캐논스
can't => can't,캔트
CANVAS => CANVAS,캔버스,캔바스
Cao Lu => Cao Lu,CaoLu,차오 루,차오루
capsule => capsule,캡슐
card => card,카드
cardigan => cardigan,카디건
Carly Rae Jepsen => Carly Rae Jepsen,CarlyRaeJepsen,칼리 레이 젭슨,칼리레이젭슨
Carmen DeLeon => Carmen DeLeon,CarmenDeLeon,카르멘 델리온,카르멘델리온
Carnival => Carnival,카니발
carol => carol,캐롤
carpool => carpool,카풀
carry => carry,캐리
cartoon => cartoon,카툰
Carys => Carys,캐리스,카리스
Cash Cash => Cash Cash,CashCash,캐쉬 캐쉬,캐쉬캐쉬
CASH KiD => CASH KiD,CASHKiD,캐쉬 키드,캐쉬키드
casual => casual,캐쥬얼
Cat => Cat,캣
Catharsis => Catharsis,카타르시스
Celebration => Celebration,셀레브레이션
Celebrities => Celebrities,셀러브리티스,셀레브리티스
Celebrity => Celebrity,셀러브리티,셀리브리티
Celine => Celine,셀린
Century => Century,센츄리
CEO => CEO,씨이오
Cerberus => Cerberus,케르베로스
Cereal => Cereal,시리얼
Cha Cha => Cha Cha,ChaCha,차 차,차차
Chad Future => Chad Future,ChadFuture,채드 퓨처,채드퓨처
CHAI => CHAI,이수정
challenge => challenge,챌린지
Champagne => Champagne,샴페인
champion => champion,챔피온,챔피언
Champions => Champions,챔피온스,챔피언스
Chance => Chance,챈스,찬스
change => change,체인지
Changer => Changer,체인저
Channel Tres => Channel Tres,ChannelTres,채널 트레스,채널트레스
CHANYEOL => CHANYEOL,찬열,엑소,EXO
chaos => chaos,카오스,케이오스
Charli XCX => Charli XCX,CharliXCX,찰리 XCX,찰리XCX
Charlie Puth => Charlie Puth,CharliePuth,찰리 푸스,찰리푸스
Charlotte Lawrence => Charlotte Lawrence,CharlotteLawrence,샤롯 로렌스,샤롯로렌스
Chaser => Chaser,체이서
Cheat Codes => Cheat Codes,CheatCodes,치트코즈,치트 코즈
Check => Check,첵
Checkers => Checkers,체커스
cheeks => cheeks,칙스
cheer => cheer,치어
Chelsea Cutler => Chelsea Cutler,ChelseaCutler,첼시 커틀러,첼시커틀러
Chemicals => Chemicals,케미컬즈
CHEN => CHEN,첸
CHERR!SH => CHERR!SH,cherrish,체리시,체리쉬
Cherries => Cherries,체리스
cherry => cherry,체리
Cherry Bullet => Cherry Bullet,CherryBullet,체리 블렛,체리블렛
CherryB => CherryB,체리비
Chess => Chess,체스
Chew => Chew,츄
CHICKEN => CHICKEN,치킨
CHILD => CHILD,차일드
Chill out => Chill out,Chillout,칠아웃,칠 아웃
Chillin Homie => Chillin Homie,ChillinHomie,칠린호미,칠린 호미
Chills => Chills,칠스
CHIMMI => CHIMMI,취미
Chloe x Halle => Chloe x Halle,ChloexHalle,클로이 앤 할리,클로이앤할리
Chococo => Chococo,초코코
Chocolate => Chocolate,초콜릿,초콜렛
Chopin => Chopin,쇼팽
Chopsticks => Chopsticks,찹스틱스
Choyoung => Choyoung,초영
Chris Brown => Chris Brown,ChrisBrown,크리스 브라운,크리스브라운
Chris Stapleton => Chris Stapleton,ChrisStapleton,크리스 스테이플턴,크리스스테이플턴
CHRISTIAN DIOR => CHRISTIAN DIOR,CHRISTIANDIOR,크리스챤 디올,크리스챤디올
Christian French => Christian French,ChristianFrench,크리스찬 프렌치,크리스찬프렌치
Christmas => Christmas,크리스마스,Xmas,X-mas,X마스
Christoph Eschenbach => Christoph Eschenbach,ChristophEschenbach,크리스토프 에셴바흐,크리스토프에셴바흐
Christopher => Christopher,크리스토퍼
CHROMANCE => CHROMANCE,크로망스
Chu => Chu,츄
chuseok => chuseok,추석
Ciara => Ciara,시에라,시애라
Cigarette => Cigarette,시가렛,씨가렛
Cignature => Cignature,시그니처
Ciipher => Ciipher,싸이퍼
Cilla => Cilla,실라
Cinema => Cinema,시네마,씨네마
Circle => Circle,서클,서클
Circles => Circles,서클스,써클스
city => city,시티,씨티
CityNoise => CityNoise,시티노이즈
Claire Rosinkranz => Claire Rosinkranz,ClaireRosinkranz,클레어 로신크란츠,클레어로신크란츠
Clarity => Clarity,클래리티
Classic => Classic,클래식
claus => claus,클로스
CLC => CLC,씨엘씨
Clean Bandit => Clean Bandit,CleanBandit,클린 밴딧,클린밴딧
Clear => Clear,클리어
clementine => clementine,클레멘타인
Clinton Kane => Clinton Kane,ClintonKane,클린턴 케인,클린턴케인
Clock => Clock,클락
Clockwork => Clockwork,클록워크,클락워크
close => close,클로스,클로즈
Closed => Closed,클로즈드
closer => closer,클로저,클로서
Cloud => Cloud,클라우드
CLOUDS => CLOUDS,클라우즈
cloudy => cloudy,클라우디
club => club,클럽
Cluster => Cluster,클러스터
Coast => Coast,코스트
coaster => coaster,코스터
Coco => Coco,코코
Coffee => Coffee,커피
Coin => Coin,코인
Coke & Mentos => Coke & Mentos,코크앤멘토스
Cola => Cola,콜라
cold => cold,콜드
Coldplay => Coldplay,콜드플레이,콜플
color => color,컬러
Colors => Colors,컬러스
Come => Come,컴
Comics => Comics,코믹스
coming => coming,커밍
Company => Company,컴퍼니
Compares => Compares,컴페어스
Complete => Complete,컴플리트
Con Me => Con Me,ConMe,콘 미,콘미
Conan Gray => Conan Gray,ConanGray,코난 그레이,코난그레이
Concern => Concern,컨선,컨썬
Concerto => Concerto,콘체르토
Confidence => Confidence,컨피던스
Confusion => Confusion,콘퓨젼,컨퓨젼,콘퓨전,컨퓨전
Congratulations => Congratulations,콩그레츌레이션스,콩그레출레이션스
Conor Maynard => Conor Maynard,ConorMaynard,코너 메이너드,코너메이너드
Consequences => Consequences,컨시퀀스
Consolation => Consolation,콘솔레이션,컨솔레이션
Control => Control,컨트롤
CONVERSATIONS => CONVERSATIONS,컨버세이션스,컨버세이션즈
COOL => COOL,쿨
Coral => Coral,코랄
Coral J => Coral J,CoralJ,코럴 제이,코럴제이
Cosmic Boy => Cosmic Boy,코스믹 보이
Cosmo's Midnight => Cosmo's Midnight,Cosmos Midnight,CosmosMidnight,코스모스 미드나잇,코스모스미드나잇
Couple => Couple,커플
cover => cover,커버
Covet => Covet,코벳
covid19 => covid19,코로나,코비드나인틴
cozy => cozy,코지
CRAVITY => CRAVITY,크래비티
Crazy => Crazy,크레이지
Cream => Cream,크림
Creations => Creations,크리에이션스
CREATOR => CREATOR,크리에이터
credit => credit,크레딧
crime => crime,크라임
Criminal => Criminal,크리미널,크리미날
Crocodile => Crocodile,크로코다일
Cross => Cross,크로스
CROWDED => CROWDED,크라우디드
Crush => Crush,크러쉬
cry => cry,크라이
crying => crying,크라잉
Crystal => Crystal,크리스탈
cuddle => cuddle,커들
Cupid => Cupid,큐피드
Cutthroat => Cutthroat,컷스로트,컷스롯
D&E => D&E,동해,은혁,슈퍼주니어
D. O. => 디오,도경수.DO
D.D.D => D.D.D,디디디
D1CE => D1CE,디원스
DA DA! => DA DA!,dada,다다
DAB DAB => DAB DAB,DABDAB,답답,댑댑
DADADA => DADADA,다다다
Daddy => Daddy,대디
Dain => Dain,다인
Daisies => Daisies,데이지스
Daisy => Daisy,데이지
DAMAGE => DAMAGE,데미지
Damons year => Damons year,Damonsyear,데이먼스 이어,데이먼스이어
DAMYE => DAMYE,담예
Dan + Shay => Dan + Shay,Dan+Shay,Dan and Shay,DanandShay,댄 앤 셰이,댄앤셰이
Dance => Dance,댄스
dancing => dancing,댄싱
DANDONG => DANDONG,댄동
Danger => Danger,데인저
Dangerous => Dangerous,댄저러스,덴저러스
Dank => Dank,댕크
Danna Paola => Danna Paola,DannaPaola,다나 파올라,다나파올라
dark => dark,다크
Darkside => Darkside,다크사이드
Darling => Darling,달링
DAUL => DAUL,다울
David Guetta => David Guetta,David Guetta,데이빗 게타,데이빗게타
Dawn => Dawn,던
day => day,데이
DAY6 => DAY6,데이식스
Daya => Daya,데이어
Daybreak => Daybreak,데이브레이크
Daydreamer => Daydreamer,데이드리머
Daydreams => Daydreams,데이드림스
days => days,데이스,데이즈
DAZZLE => DAZZLE,대즐,데즐
DBDBDIB => DBDBDIB,디비디비딥
DDARA => DDARA,따라
D-day => D-day,Dday,디데이
DDU-DU DDU-DU => DDU-DU DDU-DU,DDUDUDDUDU,뚜두뚜두
dead => dead,데드
dear => dear,디어
death => death,데쓰,데스
Decarissimo => Decarissimo,데카리시모
December => December,디셈버
Decline => Decline,디클라인
DEEP => DEEP,딥
Deja Vu => Deja Vu, DejaVu, déjà vu,déjàvu,데자뷰,데자뷔
Dejavu => Dejavu,데자뷰,데자뷔
Demente => Demente,데멘테,디멘테
Demi Lovato => Demi Lovato,DemiLovato,데미 로바토,데미로바토
DEMIAN => DEMIAN,데미안
Demon => Demon,데몬
Dennis Lloyd => Dennis Lloyd,DennisLloyd,데니스 로이드,데니스로이드
dependent => dependent,디팬던트
Desert => Desert,데저트
Destiny => Destiny,데스티니
Deux => Deux,듀스
devil => devil,데블,데빌
DEVSISTERS => DEVSISTERS,데브시스터
D-Hack => D-Hack,DHack,디핵
DIA => DIA,다이아
Diablo => Diablo,디아블로
diamond => diamond,다이아몬드
Diamonds => Diamonds,다이아몬즈
diary => diary,다이어리
DIATV => DIATV,다이아TV
DID => DID,디드
die => die,다이
Dientes => Dientes,디엔테스
Diet => Diet,다이어트
Different => Different,디퍼런트
Diggity => Diggity,디기티
Digital => Digital,디지털,디지털
Digital Farm Animals => Digital Farm Animals,DigitalFarmAnimals,디지털 팜 애니멀스,디지털팜애니멀스
Dimitri Vegas => Dimitri Vegas,DimitriVegas,디미티리 베가스,디미티리베가스
Dimitri Vegas & Like Mike => Dimitri Vegas,DimitriVegas,디미트리 베가스,디미트리베가스,Like Mike,LikeMike,라이크 마이크,라이크마이크
DINDIN => DINDIN,딘딘
Dinosaurs => Dinosaurs,다이노소어
DIOS => DIOS,디오스
Diplo => Diplo,디플로
Direction => Direction,디렉션
DIRTY => DIRTY,더티
disappear => disappear,디스어피어
Disclosure => Disclosure,디스클로저
Disco => Disco,디스코
dish => dish,디쉬
Disney => Disney,디즈니
Dispatch => Dispatch,디스패치
DISRUPTOR => DISRUPTOR,디스럽터
distance => distance,디스탄스,디스턴스
District 9 => District 9,District9,디스트릭트 나인,디스트릭트나인
DITTO => DITTO,디토
Diva => Diva,디바
DJ Khaled => DJ Khaled,DJKhaled,DJ 칼리드,DJ칼리드,디제이 칼리드,디제이칼리드
DJ Snake => DJ Snake,DJSnake,디제이 스네이크,디제이스네이크
DJ Sparrow => DJ Sparrow,DJSparrow,디제이스패로우,디제이 스패로우
DJ Tiz => DJ Tiz,DJTiz,디제이 티즈,디제이티즈
DKB => DKB,다크비
DM => DM,딩고뮤직
DMT (Do Ma Thang) => DMT (Do Ma Thang),디엠티,두마땡,두마쌩
DNA => DNA,디엔에이
Do 4 Me => Do 4 Me,Do4Me,두포미
DOCKING => DOCKING,도킹
DODODO => DODODO,두두두
dogs => dogs,도그스
Doja Cat => Doja Cat,DojaCat,도자 캣,도자캣
DOKO => DOKO,도코
Dolly Parton => Dolly Parton,돌리 파튼
Dominic Fike => Dominic Fike,DominicFike,도미닉 파이크,도미닉파이크
Don Diablo => Don Diablo,DonDiablo,돈 디아블로,돈디아블로
Don Sign. => Don Sign.,DonSign,돈 싸인,돈싸인
Don Toliver => Don Toliver,돈 톨리버,돈톨리버
done => done,던
DONGHAE => DONGHAE,동해,슈퍼주니어,D&E
DONGKIZ => DONGKIZ,동키즈
don't => don't,돈트
Donut => Donut,도넛,도너트
door => door,도어
Dopamine => Dopamine,도파민
Doris Terrace => Doris Terrace,도리스 테라스
Double => Double,더블
Dove Cameron => Dove Cameron,DoveCameron,도브 카메론,도브카메론
down => down,다운
DOYOUNG => DOYOUNG,도영
DPR LIVE => DPR LIVE,DPRLIVE,디피알 라이브,디피알라이브
Dr. => Dr.,닥터
Drama => Drama,드라마
DRAMARAMA => DRAMARAMA,드라마라마
DRAWBACK => DRAWBACK,드로우백
dream => dream,드림
Dreamcatcher => Dreamcatcher,드림캐쳐
Dreamer => Dreamer,드리머
Dreamer Boy => Dreamer Boy,DreamerBoy,드리머보이,드리머 보이
Dreaming => Dreaming,드리밍
Dreamlet => Dreamlet,드림렛
DreamNote => DreamNote,드림노트
dress => dress,드레스
drifting => drifting,드리프팅
Drinks => Drinks,드링크스
Drive => Drive,드라이브
drivers => drivers,드라이버스
DROP => DROP,드롭,드랍
Drug => Drug,드러그,드럭
D'tour => D'tour,디투어,dtour
Dua Lipa => Dua Lipa,DuaLipa,두아 리파,두아리파
dumb => dumb,덤
DUMB DUMB => DUMB DUMB,DUMBDUMB,덤 덤,덤덤
DUN => DUN,던
DVBBS => DVBBS,덥스
DWAY! => DWAY!,DWAY,디웨이
Dynamite => Dynamite,다이나마이트,다이너마이트
Eagle => Eagle,이글
EARFQUAKE => EARFQUAKE,어쓰퀘이크,얼쓰퀘이크
earth => earth,어쓰,얼쓰
Easier => Easier,이지어
East => East,이스트
easy => easy,이지
ECHO => ECHO,에코
ECLIPSE => ECLIPSE,이클립스
Ecobridge => Ecobridge,에코브릿지
Ed Sheeran => Ed Sheeran,EdSheeran,에드 시런,에드시런
Eddie Benjamin => Eddie Benjamin,EddieBenjamin,에디 벤자민,에디벤자민
Eden => Eden,에덴
EDM => EDM,이디엠
Eeny Meeny => Eeny Meeny,이니미니
Egoist => Egoist,에고이스트
Egotism => Egotism,에고티즘
El Alfa => ElAlfa,엘 알파,엘알파
EL Rune => EL Rune,ELRune,엘 룬,엘룬
EL TORNADO => EL TORNADO,ELTORNADO,엘토네이도,엘 토네이도
E'LAST => E'LAST,ELAST,엘라스트
Electric => Electric,일렉트릭
Elena Coda => Elena Coda,ElenaCoda,엘레나 코다,엘레나코다
Elevator => Elevator,엘리베이터
Ella Eyre => Ella Eyre,EllaEyre,엘라 에어,엘라에어
Ellie Goulding => Ellie Goulding,EllieGoulding,엘리 굴딩,엘리굴딩
ELRIS => ELRIS,앨리스
Elton John => Elton John,EltonJohn,엘튼 존,엘튼존
EMO => emo,이모
Empty => Empty,엠티,엠프티
ENCORE => ENCORE,앙코르
End => End,엔드
ending => ending,엔딩
enermy => enermy,에너미
ENFP => ENFP,MBTI
Englishman => Englishman,잉글리쉬맨
ENHYPEN => ENHYPEN,엔하이픈
enough => enough,이너프
Enzo => Enzo,엔조
EPILOGUE => EPILOGUE,에필로그
Eric Bellinger => Eric Bellinger,EricBellinger,에릭 벨린저,에릭벨린저
Eros => Eros,에로스
error => error,에러
ESCAPE => ESCAPE,이스케이프
ESFJ => ESFJ,MBTI
ESTJ => ESTJ,MBTI
ESTP => ESTP,MBTI
Eternal => Eternal,이터널
Eternally => Eternally,이터널리
EUNHA => EUNHA,은하
EUNHYUK => EUNHYUK,은혁,슈퍼주니어,D&E
EVEE => EVEE,이브
everbody => everbody,에브리바디
EVEREST => EVEREST,에베레스트
everything => everything,에브리띵,에브리씽
Everytime => Everytime,애브리타임
Excalibur => Excalibur,엑스칼리버
Excuse => Excuse,익스큐즈 
Excuses => Excuses,익스큐지스,엑스큐지스,익스큐시스,엑스큐시스
exhale => exhale,엑스헤일
EXID => EXID,이엑스아이디
Exist => Exist,이그지스트
EXIT => EXIT,엑시트,엑싯
EXN => EXN,이엑센,을씨년
EXO => EXO,엑소
Expansion => Expansion,익스펜션
eye => eye,아이
eyes => eyes,아이스,아이즈
F.able (페이블) => F.able,페이블,Fable
Face => Face,페이스
facetime => facetime,페이스타임
Fadeaway => Fadeaway,페이드어웨이
Fair => Fair,페어
Fairy => Fairy,페어리
faith => faith,페이스
Fake => Fake,페이크
Fakering => Fakering,페이크링
fall => fall,폴
Fall Out Boy => Fall Out Boy,FallOutBoy,폴 아웃 보이,폴아웃보이
Falling => Falling,폴링
Fancy => Fancy,팬시,펜시
FANTASIA => FANTASIA,판타지아,환타지아
FANTASTIC => FANTASTIC,판타스틱
Fantasy => Fantasy,판타지,환타지
Faouzia => Faouzia,파우지아
Far => Far,파
Farewell => Farewell,페어웰
Farm => Farm,팜
Farruko => Farruko,파루코
Fault => Fault,폴트
Favorite => Favorite,페이보릿,페이버릿
fear => fear,피어
Feather => Feather,페더
Feed => Feed,피드
FEEDBACK => FEEDBACK,피드백
Feel => Feel,필
feeling => feeling,필링
Feels => Feels,필스,필즈
feet => feet,피트,핏
Felly => Felly,펠리
Ferris => Ferris,페리스
Festival => Festival,페스티벌
FEVER => FEVER,피버
Field => Field,필드
FIESTA => FIESTA,피에스타
Fifth Harmony => Fifth Harmony,FifthHarmony,피프스 하모니,피프스하모니
Fifty => Fifty,피프티
fight => fight,파이트
Fill => Fill,필
film => film,필름
finally => finally,파이널리
FIND => FIND,파인드
fine => fine,파인
FINGERTIP => FINGERTIP,핑거팁
Fire => Fire,파이어
Firework => Firework,파이어웍스
first => first,파이어
Fish => Fish,피쉬
FIVE => FIVE,파이브
Flame => Flame,플레임,플래임
FLASH => FLASH,플래시
FLEX => FLEX,플렉스
Floody => Floody,플루디
Flospoon => Flospoon,플로스푼
flower => flower,플라워
fly => fly,플라이
FOCUS => FOCUS,포커스
Folded Dragons => Folded Dragons,FoldedDragons,폴더드 드래곤즈,폴더드드래곤즈
Follow => Follow,팔로우
Foo Fighters => Foo Fighters,FooFighters,푸 파이터스,푸파이터스
Food => Food,푸드
fool => fool,풀
Foolish => Foolish,풀리쉬,풀리시
Foot => Foot,풋
for => for,포
forest => forest,포레스트
forever => forever,포에버,폴에버
forget => forget,포겟
fortune => fortune,포츈
Foster The People => Foster The People,FosterThePeople,포스터 더 피플,포스터더피플
Fousheé => Fousheé,Foushee,포우쉐
Frail => Frail,프레일
Frame => Frame,프레임
franchise => franchise,프랜차이즈
Frankenstein => Frankenstein,프랑케슈타인,프랑켄스타인
Freaking => Freaking,프리킹
free => free,프리
Freezing => Freezing,프리징
FreezyBone => FreezyBone,프리지본
French Montana => French Montana,FrenchMontana,프렌치 몬타나,프렌치몬타나
Friday => Friday,프라이데이
friends => friends,프렌즈
Frog => Frog,프로그
from => from,프롬
Fromis_9 => Fromis_9,Fromis9,프로미스 나인,프로미스나인
front => front,프론트
Frost => Frost,프로스트
FRUITY => FRUITY,프루티
Fuck => Fuck,퍽
Fulanito => Fulanito,풀라니토
fun => fun,펀,재미
Funk => Funk,펑크
Funk LeBlanc => Funk LeBlanc,FunkLeBlanc,펑크 르블랑,펑크르블랑
Funny => Funny,퍼니
future => future,퓨처,퓨쳐
FX => FX,함수진
G.B.T.B. => G.B.T.B.,지비티비
G.Brown => G.Brown,Gbrown,지브라운,지 브라운
G.G.B => G.G.B,GGB,지지비,쥐쥐비
Galantis => Galantis,갈란티스
galaxy => galaxy,갤럭시
Gallery => Gallery,갤러리
GAMBLER => GAMBLER,갬블러
Gang => Gang,갱
Gari => Gari,가리
Gas => Gas,가스
GASHI => GASHI,가시
Gavin James => Gavin James,GavinJames,개빈 제임스,개빈제임스
GD => GD,지디,지드레곤
G-DRAGON => G-DRAGON,GDRAGON,지드래곤,GD,지디
G-Eazy => G-Eazy,Geazy,지이지,지 이지
Generation => Generation,제너레이션
Genie => Genie,지니
genius => genius,지니어스
Georgia Ku => Georgia Ku,GeorgiaKu,조지아 구,조지아구
Getting => Getting,게팅
Ghost => Ghost,고스트
Giant => Giant,자이언트
giddy => giddy,기디
GIFT => GIFT,기프트
girl => girl,걸
Girlfriend => Girlfriend,걸프렌드
Girls => Girls,걸스
given => given,기븐
Giveon => Giveon,기브온
GLASSY => GLASSY,글래시
glitch => glitch,글리치
Glitter => Glitter,글리터
Gloomy => Gloomy,글루미
Gloria => Gloria,글로리아
Glow => Glow,글로우
GLOWCEAN => GLOWCEAN,글로우션
GO => GO,고
goat => goat,고트
god => god,갓
goes => goes,고즈
gold => gold,골드
Golden  => Golden,골든
Gone => Gone,곤
Good => Good,굿,굳
Goodboys => Goodboys,Good Boys,굿보이즈,굿 보이즈
Goodbye => Goodbye,굿바이
Good-bye => Good-bye,goodbye,굿바이
GooseBumps => GooseBumps,구스범스
GORILLA => GORILLA,고릴라
Got => Got,갓
GOT U => GOT U,GOTU,갓 츄,갓츄
GOT7 => GOT7,갓세븐
GOTCHA => GOTCHA,갓차,가챠,갓챠
GOTTA => GOTTA,가타
GOT'YA => GOT'YA,GOTYA,갓챠
Grace => Grace,그레이스
Gracie Abrams => Gracie Abrams,GracieAbrams,그레이시 에이브럼스,그레이시에이브럼스
Graduation => Graduation,그래듀에이션
GRASS => GRASS,그래쓰
Graveyard => Graveyard,그레이브야드
GRAVITY => GRAVITY,그래비티,그레비티
greatest => greatest,그레이티스트
GreatGuys => GreatGuys,멋진녀석들
Greedyy => Greedyy,그리디
greegura => greegura,그리구라
Green Day => Green Day,GreenDay,그린 데이,그린데이
G-reyish => G-reyish,Greyish,그레이시
Greyson Chance => Greyson Chance,GreysonChance,그레이슨 챈스,그레이슨챈스
Griff => Griff,그리프
Grizzly => Grizzly,그리즐리
Gromee => Gromee,그로미
Groove => Groove,그루브
Ground => Ground,그라운드
Gryffin => Gryffin,그리핀
Guaynaa => Guaynaa,구아이나
Gucci => Gucci,구찌
GUESS => GUESS,게스
guidance => guidance,가이던스
Guitar => Guitar,기타
Gum => Gum,검
GUNSHOT => GUNSHOT,건샷
Guy => Guy,가이
Guys => Guys,가이스
Gwen Stefani => Gwen Stefani,GwenStefani,그웬 스테파니,그웬스테파니
GYE0M => GYE0M,겸
H.E.R. => H.E.R.,HER,헐,허
H1GHRMUSIC => H1GHRMUSIC,하이어뮤직
Habit => Habit,해빗
habits => habits,해빗츠
Habitual => Habitual,해비추얼,해비츄얼
HAECHAN => HAECHAN,해찬,NCT 127,NCT127,엔씨티 127,엔씨티127,NCT
HAHAHOHO => HAHAHOHO,하하호호
HAJIN => HAJIN,하진
Hallelujah => Hallelujah,할렐루야
Hallucinate => Hallucinate,할루시네이트
Hallucy => Hallucy,할루시
Halsey => Halsey,할시
Hands => Hands,핸즈
Hans Zimmer => Hans Zimmer,HansZimmer,한스짐머,한스 짐머
HAPPENING => HAPPENING,해프닝,헤프닝
Happiness => Happiness,해피니스,해피네스
Happy => Happy,해피
Harder => Harder,하더
Hardest => Hardest,하디스트
Harleys => Harleys,할리스
Harry Styles => Harry Styles,HarryStyles,해리 스타일스,해리스타일스
Hate => Hate,헤이트
Have => Have,해브
Hawái => Hawái,하와이
Hawaian => Hawaian,하와이안
Hawaii => Hawaii,하와이
Heachi => Heachi,해치
head => head,헤드
Headache => Headache,헤드에이크,헤드애이크,해드에이크,해드애이크
HEADLINE => HEADLINE,헤드라인
heal => heal,힐
Healthy => Healthy,헬시,헬씨
Healy => Healy,힐리
Hear => Hear,히어
heart => heart,하트
Heartbeat => Heartbeat,하트비트
Heartbreak => Heartbreak,하트브레이크
HEAT => HEAT,히트
Heather => Heather,헤더
heaven => heaven,헤븐
Heavy => Heavy,해비
Hedwig => Hedwig,헤드위그
HELICOPTER => HELICOPTER,헬리콥터,헬리콥타
hell => hell,헬
Hello => Hello,헬로
HELLOVENUS => HELLOVENUS,헬로비너스
HELP => HELP,헬프
her => her,허,헐
HERO => HERO,히어로
Heroes => Heroes,히어로즈,히어로스
hey => hey,헤이
hi => hi,하이
Hi*DRAULIC5 => HiDRAULIC5,하이드롤릭파이브,하이드롤릭5
hiccup => hiccup,히컵
high => high,하이
HIGH4 => HIGH4,하이포
Highball => Highball,하이볼
Higher => Higher,하이어
Hi-L => Hi-L,HiL,하이 엘,하이엘
HIP => HIP,힙
hiphop => hiphop,힙합
Hips => Hips,힙스
Hisaishi Joe => Hisaishi Joe,HisaishiJoe,히사이시 조,이사이시조
Hitchhiker => Hitchhiker,히치하이커
hitmeup => hitmeup,힛미업
Hocus Pocus => Hocus Pocus,호커스포커스
HOLA! => HOLA!,HOLA,올라,홀라
Hold => Hold,홀드
HOLIDAY => HOLIDAY,홀리데이,할러데이,할리데이,홀러데이
Hollow => Hollow,할로우
hollywood => hollywood,헐리우드,헐리웃,할리우드
holy => holy,홀리
home => home,홈
HOME;RUN => HOME;RUN,homerun,홈런
homebody => homebody,홈바디
homezone => homezone,홈존
Honey => Honey,허니,하니
HONG EUNKI => HONG EUNKI,HONGEUNKI,홍은기
HONNE => HONNE,혼네
Hoon => Hoon,훈
hope => hope,홉
Hope Tala => Hope Tala,HopeTala,호프탈라,호프 탈라
Horizon => Horizon,호라이즌
hot => hot,핫
HOT ISSUE => HOT ISSUE,HOTISSUE,핫이슈
hotel => hotel,호텔
Houdini => Houdini,후디니
Hour => Hour,아워
How => How,하우
HOWL => HOWL,하울
HOYA => HOYA,호야
HRTBRKN => HRTBRKN,heart broken,하트 브로큰,하트브로큰
HRVY => HRVY,하비
Hug => Hug,허그
Hula Hoops => Hula Hoops,HulaHoops,훌라 훕스,훌라훕스
Human => Human,휴먼
Hurt => Hurt,허트
Hurting => Hurting,허팅
HUSH => HUSH,허쉬,허시
Hwa Sa => Hwa Sa,HwaSa,화사
hwaa => hwaa,화
Hwi hwi => Hwi hwi,휘휘
HYLT => HYLT,how you like that,하우 유 라이크 댓,하우유라이크댓
HYNN => HYNN,흰
HYO => HYO,효연
HYUK => HYUK,혁
HYUNKI => HYUNKI,현기
I => I,아이
I.O.I => I.O.I,IOI,아이오아이
Ice => Ice,아이스
Ice Cream => Ice Cream,IceCream,아이스크림
ICE T => ICE T,ICET,아이스 티,아이스티
ICHILLIN' => ICHILLIN',ICHILLIN,아이칠린
ICONS => ICONS,아이콘즈
ICY => ICY,아이시,아이씨
ID => ID,아이디
idea => idea,아이디어
Idina Menzel => Idina Menzel,이디나 멘젤
IDOL => IDOL,아이돌
if => if,이프
iKON => Ikon,아이콘
i-land => i-land,아이랜드
ILHO => ILHO,일호,장일호
I'll => I'll,아일,아이윌
ILLENIUM => ILLENIUM,일레니움
ILLUSION => ILLUSION,일루션,일루젼
IMAGINE => IMAGINE,이매진
Imagine Dragons => Imagine Dragons,ImagineDragons,이매진 드래곤스,이매진드래곤스
Imanbek => Imanbek,이만벡
IMLAY => IMLAY,임레이
Imported => Imported,임포티드
In => In,인
IN THE CITY => IN THE CITY,INTHECITY,인 더 시티,인더시티
INCEPTION => INCEPTION,인셉션
Inn => Inn,인
INNER => INNER,이너
Insane => Insane,인세인
inside => inside,인사이드
Insomnia => Insomnia,인솜니아
Instruction => Instruction,인스트럭션
INTEC => INTEC,인택
Intentions => Intentions,인텐션스
Interlude => Interlude,인터루드
into => into,인투
Invisible => Invisible,인비저블
IRENE => IRENE,아이린,레드벨벳,RedVelvet
is => is,이스,이즈
Isaac Dunbar => Isaac Dunbar,IsaacDunbar,아이작 던바,아이작던바
ISÁK => ISÁK,ISAK,이사크,아이작
iScreaM => iScreaM,아이스크림
ISFJ => ISFJ,MBTI
ISFP => ISFP,MBTI
ISLAND => ISLAND,아일랜드
ISTJ => ISTJ,MBTI
ISTP => ISTP,MBTI
IT => IT,잇
It's => It's,잇츠,이츠
ITZY_GUESSWHO => GUESSWHO,게스후
IYAH => IYAH,아이야
izi => izi,이지
J Balvin => J Balvin,Jbalvin,제이 발빈,제이발빈
J Rabbit => J Rabbit,Jrabbit,제이 레빗,제이레빗
J.Yung => J.Yung,JYung,제이 영,제이영
Ja Mezz => Ja Mezz,자 메즈
Jack Harlow => Jack Harlow,JackHarlow,잭 할로우,잭할로우
Jack Kays => Jack Kays,JackKays,잭 케이스,잭케이스
Jackie Kennedy => Jackie Kennedy,재키 케네디,재클린 케네디
JACKPOT => JACKPOT,잭팟
Jackson Wang => Jackson Wang,JacksonWang,잭슨 왕,잭슨왕,잭슨
Jacob Collier => Jacob Collier,JacobCollier,제이콥 콜리어,제이콥콜리어
JAEHYUN => JAEHYUN,재현,NCT 127,NCT127,NCT,엔씨티 127,엔씨티127
Jaira Burns => Jaira Burns,JairaBurns,자이라 번스,자이라번스
JAJA => JAJA,자자
JANNABI => JANNABI,잔나비
JASMIN => JASMIN,자스민
Jasmine Thompson => Jasmine Thompson,JasmineThompson,재스민 톰슨,재스민톰슨
Jason Derülo => Jason Derülo,JasonDerulo,제이슨 데룰로,제이슨데룰로
Jason Mraz => Jason Mraz,JasonMraz,제이슨 므라즈,제이슨므라즈
Jawsh 685 => Jawsh 685,Jawsh685,자우쉬 685,자우쉬685
Jax => Jax,잭스
Jax Jones => Jax Jones,JaxJones,잭스존스,잭스 존스
JAY B => JAY B,JAYB,제이 비,제이비
JC Stewart => JC Stewart,JCStewart,JC 스튜어트,JC스튜어트
J-Cera => J-Cera,JCera,제이세라
Je T′aime => Je T′aime,JeTaime,쥬뗌므,쥬 뗌므
Jealous => Jealous,젤러스
Jealousy => Jealousy,젤러시
Jeiff => Jeiff,제이프
Jello => Jello,젤로
Jelly => Jelly,젤리
jenga => jenga,젠가
JENNIE => JENNIE,제니,블랙핑크,BLACKPINK
JENYER => JENYER,전지윤
Jeonghyeon => Jeonghyeon,정현
JEONWOONG => JEONWOONG,전웅,AB6IX,에이비식스
Jeremy Zucker => Jeremy Zucker,JeremyZucker,제레미 주커,제레미주커
JERO => JERO,제로
Jessie Reyez => Jessie Reyez,JessieReyez,제시 레예스,제시레예스
jesus => jesus,지저스
JIEON => JIEON,지언
Jimmie Allen => Jimmie Allen,JimmieAllen,지미 알렌,지미알렌
JIN JU => JIN JU,JINJU,진주
JJ Project => JJ Project,JJProject,JJ 프로젝트,JJ프로젝트
John K => John K,JohnK,존 케이,존케이
John Legend => John Legend,JohnLegend,존 레전드,존레전드
John Mayer => John Mayer,JohnMayer,존 메이어,존메이어
John OFA Rhee => John OFA Rhee,이요한
JOHNNY => JOHNNY,쟈니,NCT 127,NCT127,엔씨티 127,엔씨티127,NCT
johnny & june => johnny & june,johnny&june,조니앤준,조니 앤 준
Johnny Orlando => Johnny Orlando,JohnnyOrlando,조니 올란도,조니올란도
Johnny Stimson => Johnny Stimson,JohnnyStimson,조니 스팀슨,조니스팀슨
Joke => Joke,조크
Joker => Joker,조커
Jomie => Jomie,조미
Jonas Blue => Jonas Blue,JonasBlue,조나스 블루,조나스블루
Jonas Brothers => Jonas Brothers,JonasBrothers,조나스 브라더스,조나스브라더스
Jonas Kaufmann => Jonas Kaufmann,JonasKaufmann,요나스 카우프만,요나스카우프만
JOO JIN-WOO => JOO JIN-WOO,JOOJINWOO,주진우
JOOHONEY => JOOHONEY,주헌,MONSTA X,MONSTAX,몬스타 엑스,몬스타엑스
JOON => JOON,준
Jopping => Jopping,쟈핑,자핑,조핑
Josh => Josh,조시
Joshua Bassett => Joshua Bassett,JoshuaBassett,조슈아 바셋,조슈아바셋
Josie Man => Josie Man,JosieMan,조시 맨,조시맨
journey => journey,져니
Joy Crookes => Joy Crookes,JoyCrookes,조이 크룩스,조이크룩스
JP Saxe => JP Saxe,JPSaxe,JP색스,JP색스,JP삭스,JP삭스
Juice => Juice,쥬스,주스
Juice WRLD => Juice WRLD,JuiceWRLD,주스 월드,주스월드,주스 월드,쥬스월드
JUICY => JUICY,쥬시,쥬씨
jukebox => jukebox,주크박스
Julia Michaels => Julia Michaels,쥴리아 마이클스,줄리아 마이클스
july => july,줄라이
Jump => Jump,점프
Jump AR => Jump,점프,AR,에이알
JUNGWOO => JUNGWOO,정우,NCT 127,NCT127,엔씨티 127,엔씨티127,NCT
JUNNY => JUNNY,주니
Just => Just,져스트,저스트
JUSTHIS => JUSTHIS,저스디스
Justin => Justin,저스틴
Justin Bieber => Justin Bieber,JustinBieber,저스틴 비버,저스틴비버
Justin Timberlake => Justin Timberlake,JustinTimberlake,저스틴 팀버레이크,저스틴팀버레이크
Jvcki Wai => Jvcki Wai,JvckiWai,재키 와이,재키와이
JYP => JYP,제이와이피,박진영
K/DA => K/DA,케이디에이,KDA
K2 => K2,케이투
Kacey Musgraves => Kacey Musgraves,KaceyMusgraves,케이시 머스그레이브스,케이시머스그레이브스
KAI => KAI,카이,EXO,엑소
Kali Uchis => Kali Uchis,KaliUchis,칼리 우치즈,칼리우치즈
Kane Brown => Kane Brown,KaneBrown,케인브라운,케인 브라운
KANGSEUNGYOON => KANGSEUNGYOON,강승윤,WINNER,위너
Kara => Kara,카라
KARD => KARD,카드
KARMA => KARMA,카르마
Karol G => Karol G,KarolG,카롤 지,카롤지,캐롤 지,캐롤지
kart => kart,카트
Kathryn Stott => Kathryn Stott,KathrynStott,캐서린 스톳,캐서린스톳
KATIE => KATIE,케이티
Katy Perry => Katy Perry,KatyPerry,케이티 페리,케이티페리
KAYTRANADA => KAYTRANADA,케이트라나다
KBO => KBO,케이비오,프로야구
KCM => KCM,케이씨엠
Keeper => Keeper,키퍼
Kehlani => Kehlani,켈라니
Kei => Kei,케이,러블리즈,Lovelyz
Keith Urban => Keith Urban,KeithUrban,키스 어번,키스어번
Kelly Clarkson => Kelly Clarkson,KellyClarkson,켈리 클락슨,켈리클락슨
Kenny => Kenny,케니
Kenzie => Kenzie,켄지
Kesha => Kesha,케샤
keshi => keshi,케시
KEY => KEY,키,샤이니,SHINee
Khaki => Khaki,카키
Khalid => Khalid,칼리드
Khundi Panda => Khundi Panda,KhundiPanda,쿤디 판다,쿤디판다
KIA 타이거즈 => KIA,기아
kick => kick,킥
Kid Cudi => Kid Cudi,KidCudi,키드 커디,키드커디
Kid Milli => Kid Milli,KidMilli,키드 밀리,키드밀리
Kiddo => Kiddo,키도
KIDS => KIDS,키즈
Kidult => Kidult,키덜트
Kiki Dee => Kiki Dee,KikiDee,키키 디,키키디
kill => kill,킬
KILLA => KILLA,킬라
Killer => Killer,킬러
KIMDONGHYUN => KIMDONGHYUN,김동현,AB6IX,에이비식스
Kina => Kina,키나
kind => kind,카인드
KINDA BLUE => KINDA BLUE,KINDABLUE,킨다 블루,킨다블루
kindness => kindness,카인드니스
KINGDOM => KINGDOM,킹덤
kings => kings,킹스,킹즈
Kings Of Leon => Kings Of Leon,KingsOfLeon,킹스 오브 리온,킹스오브리온
Kira Puru => Kira Puru,KiraPuru,키라 푸루,키라푸루
kiss => kiss,키스
KISSXS => KISSXS,키세스
kitchen => kitchen,키친
Kito => Kito,키토
KKOIN => KKOIN,꼬인
KLANG => KLANG,클랑
Knight => Knight,나이트
KNOCK => KNOCK,낙,녹,노크
know => know,노
Ko Ko Bop => Ko Ko Bop,코코밥
Kona => Kona,코나
Kool => Kool,쿨
KPOP => KPOP,케이팝
Kriz => Kriz,크리즈
KSI => KSI,케이에스아이
KT => KT,케이티
KT 위즈 => KT,케이티
Kura Kura => Kura Kura,KuraKura,쿠라 쿠라,쿠라쿠라
Kygo => Kygo,카이고
L => L,엘
L.I.E => L.I.E,lie,라이
L.L.A.M.A => L.L.A.M.A,LLAMA,라마
la => la,라
LA DI DA => LA DI DA,라디다
LABOUM => LABOUM,라붐
Labrinth => Labrinth,라브린느
LADY => LADY,레이디
Lady GaGa => Lady GaGa,LadyGaGa,레이디 가가,레이디가가
Lalala => Lalala,랄랄라,라라라
LALALILALA => LALALILALA,라라리라라
lalasweet => lalasweet,랄라스윗
LALISA => LALISA,라리사
Lana Del Rey => Lana Del Rey,Lana Del Rey,라나 델 레이,라나델레이
LAND => LAND,랜드
lane => lane,레인
LANGUAGE => LANGUAGE,랭귀지
LANY => LANY,라니
laser => laser,레이저
last => last,라스트
LATATA => LATATA,라타타
Late => Late,레이트
lately => lately,레이틀리
Later => Later,레이터
Laugh => Laugh,래프
laughing => laughing,래핑
Lauren Han => Lauren Han,LaurenHan,로렌 한,로렌한
Lauren Jauregui => Lauren Jauregui,LaurenJauregui,로렌 하우레기,로렌하우레기
Lauren Sanderson => Lauren Sanderson,LaurenSanderson,로렌 센더슨,로렌센더슨
Lauv => Lauv,라우브
LAVA2 => LAVA,라바
Layone => Layone,래원
Lazy => Lazy,레이지
LazyBaby => LazyBaby,레이지베이비
Lea Michele => Lea Michele,LeaMichele,레아 미셀,레아미셀
League of Legends => League of Legends,LeagueofLegends,리그 오브 레전드,리그오브레전드
leap => leap,립
Learn => Learn,런
leave => leave,리브
LEEDAEHWI => LEEDAEHWI,이대휘,AB6IX,에이비식스
Lee-Nu => Lee-Nu,LeeNu,리누
Left => Left,레프트
Lele Pons => Lele Pons,LelePons,렐레 폰스,렐레폰스
Lemon => Lemon,레몬
Lennon Stella => Lennon Stella,LennonStella,레논 스텔라,레논스텔라
LEO => LEO,레오
Leon Bridges => Leon Bridges,LeonBridges,리온 브릿지스,리온브릿지스
less => less,레스
let => let,렛
let's => let's,렛츠
Letter => Letter,리터
Level => Level,레벨
Levitating => Levitating,레비테이팅
LG 트윈스 => LG,엘지
Liam Payne => Liam Payne,LiamPayne,리엄 페인,리엄페인,리암 페인,리암페인
Liar => Liar,라이어
libidO => libidO,리비도
license => license,라이센스
lie => lie,라이
life => life,라이프
Light => Light,라이트,라잇
Lighthouse => Lighthouse,라이트하우스
like => like,라이크
Like Mike => Like Mike,LikeMike,라이크 마이크,라이크마이크
Likes => Likes,라이크스
LIKEY => LIKEY,라이키
Lil Baby => Lil Baby,LilBaby,릴베이비,릴 베이비
Lil Dicky => Lil Dicky,LilDicky,릴 디키,릴디키
Lil Nas X => Lil Nas X,LilNasX,릴 나스 엑스,릴나스엑스,릴나섹
Lil Tjay  => Lil Tjay,LilTjay,릴 티제이,릴티제이
Lim Kim => Lim Kim,LimKim,김예림
Line => Line,라인
LIP => LIP,립
LISA => LISA,리사
little => little,리틀
Little Mix => Little Mix,LittleMix,리틀 믹스,리틀믹스
living => living,리빙
Lizzo => Lizzo,리조
LLANO => LLANO,라노
L-like => L-like,Llike,엘라이크
Llwyd => Llwyd,루이드
LO$ER=LO♡ER => 루저러버,loserlover
lobby => lobby,로비,라비
Loca => Loca,로카
Lock => Lock,락
Loco Contigo => Loco Contigo,LocoContigo,로코 콘티고,로코콘티고
lofi => lofi,로파이
LOHYE => LOHYE,로예
Lolo Zouaï => Lolo Zouaï,LoloZouai,롤로 주아이,롤로주아이
London Symphony Orchestra => London Symphony Orchestra,LondonSymphonyOrchestra,런던 심포니 오케스트라,런던심포니오케스트라
Loneliness => Loneliness,론리니스,론리네스
Lonely => Lonely,론리
Lonelynight => Lonelynight,론리나이트
LOOK => LOOK,룩
LOONA yyxy => LOONA yyxy,LOONAyyxy,이달의 소녀 yyxy,이달의소녀yyxy
Loop => Loop,루프
Loopy => Loopy,루피
Lose => Lose,루즈
Losing => Losing,루징
Lost => Lost,로스트
lot => lot,랏
Lotus => Lotus,로터스
Lounge => Lounge,라운지
love => love,러브,럽,luv
Love Renaissance (LVRN) => Love Renaissance,LoveRenaissance,러브 르네상스,러브르네상스,LVRN
love4eva => love4eva,러브포에버
Lovefool => Lovefool,러브풀
LOVEGalaxy => LOVE,러브,Galaxy,갤럭시
lovememore. => lovememore.,러브미모어
Lover => Lover,러버
Loveship => Loveship,러브쉽,러브십
Lovesick => Lovesick,러브식,러브씩,럽씩
Low => Low,로우
LowpassIndustry => LowpassIndustry,로우패스인더스트리
Lows => Lows,로우스
LP => LP,엘피
LSD => LSD,엘에스디
Lucid => Lucid,루시드
luck => luck,럭
Lucky Daye => ,Lucky Daye,LuckyDaye,럭키 다예,럭키다예
LUCY => LUCY,루시
Luke Christopher => Luke Christopher,LukeChristopher,루크 크리스토퍼,루크크리스토퍼
lullaby => lullaby,룰러바이,럴러바이
LULUPOP => LULUPOP,룰루팝
LUMBERJACK => LUMBERJACK,럼버잭
LUNA => LUNA,루나
lunar => lunar,루나
LUNARSOLAR => LUNARSOLAR,루나솔라
Luv => Luv,러브,love
Luv Express => Luv Express
Luven => Luven,러븐
LYSON => LYSON,리슨
M1NU => M1NU,미누
Mabel => Mabel,마벨
Mac Miller => Mac Miller,MacMiller,맥 밀러,맥밀러
Machine Gun Kelly => Machine Gun Kelly,MachineGunKelly,머신건 켈리,머신건켈리
Macklemore => Martin Garrix,MartinGarrix,마틴 개릭스,마틴개릭스,Macklemore,맥클모어,Fall Out Boy,FallOutBoy,폴 아웃 보이,폴아웃보이
mad => mad,매드
Mad Clown => Mad Clown,MadClown,매드 클라운,매드클라운
MAD MONSTER => MAD MONSTER,MADMONSTER,매드 몬스터,매드몬스터
Made => Made,메이드
Madison Beer => Madison Beer,MadisonBeer,매디슨 비어,매디슨비어
Magazines => Magazines,매거진즈
Magic => Magic,매직
MAGNET => MAGNET,마그넷
MAGO => MAGO,마고
Mahalia => Mahalia,마할리아
MAINSTREET => MAINSTREET,메인스트리트
MAJORS => MAJORS,메이져스
Make => Make,메이크
Maleek Berry => Maleek Berry,MaleekBerry,말릭베리,말릭 베리
Malibu => Malibu,말리부
Maluma => Maluma,말루마
MAMA => MAMA,마마
mamba => mamba,맘바
MAMMA MIA => MAMMA MIA,맘마미아
Man => Man,맨
Mandarin => Mandarin,만다린
Maniac => Maniac,매니악,마니악
Marc E. Bassy => Marc E. Bassy,MarcEBassy,마크 이 배시,마크이배시
MARCUS => MARCUS,마커스,마르쿠스
Maren Morris => Maren Morris,MarenMorris,마렌 모리스,마렌모리스
Mariah Carey => Mariah Carey,MariahCarey,머라이어 캐리,머라이어캐리
Marigold => Marigold,마리골드,매리골드
mario => mario,마리오
Mariposa => Mariposa,마리포사
MARK => MARK,마크,엔씨티 127,엔씨티127,NCT 127,NCT127
Mark Ronson => Mark Ronson,MarkRonson,마크 론슨,마크론슨
MARKLEE => MARKLEE,마크,엔씨티 127,엔씨티127,NCT 127,NCT127
Maroon 5 => Maroon 5,Maroon 5,마룬파이브,마룬 파이브
Married => Married,메리드
marry => marry,메리
Marshmello => Marshmello,마시멜로
Marteen => Marteen,마틴
Martin Garrix => Martin Garrix,MartinGarrix,마틴 개릭스,마틴개릭스
Martin Solveig => Martin Solveig,MartinSolveig,마르탱 솔베이그,마르탱솔베이그
martini => martini,마티니
mask => mask,마스크
Masked Wolf => Masked Wolf,MaskedWolf,마스크드 울프,마스크드울프
Matoma => Matoma,마토마
matter => matter,매터,매러
MAVERICK => MAVERICK,메버릭
MAX => MAX,맥스
MAX CHANGMIN => MAX CHANGMIN,MAXCHANGMIN,최강창민
Maybe => Maybe,메이비
Mazeltov => Mazeltov,마젤토브
MBTI => MBTI,엠비티아이
MCND => MCND,엠씨엔디
MC몽 => MC몽,엠씨몽
me => me,미
ME ME WE => ME ME WE,MEMEWE,미 미 위,미미위
ME.N.U => ME.N.U,menu,메뉴
Meduza => Meduza,메두자
Meego => Meego,미고
Meet => Meet,미트
MEGAMAX => MEGAMAX,메가맥스
Megan Thee Stallion => Megan Thee Stallion,MeganTheeStallion,메건 더 스탤리언,메건더스탤리언,메건 쓰리 스탤리언,메건 쓰리 스탤리언
Meghan Trainor => Meghan Trainor,MeghanTrainor,메간 트레이너,메간트레이너
Melody => Melody,멜로디
Memories => Memories,메모리즈,메모리스
Merry => Merry,메리
Mess => Mess,메스
met => met,멧
MHz => MHz,메가헤르츠
MI CASA SU CASA => MI CASA SU CASA,MICASASUCASA,미 카사 수 카사,미카사수카사
MIANHAE => MIANHAE,미안해
MIC Drop => MIC Drop,MICDrop,마이크 드롭,마이크드롭
Michael Buble => Michael Buble,MichaelBuble,마이클 부블레,마이클부블레
Michelle Shaprow => Michelle Shaprow,MichelleShaprow,미셸 샤프로,미셸샤프로
Microdot => Microdot,마이크로닷
middle => middle,미들
Midnight => Midnight,미드나이트
Miley Cyrus => Miley Cyrus,MileyCyrus,마일리 사이러스,마일리사이러스
Milky => Milky,밀키
MILLION => MILLION,밀리언
MILLIONS => MILLIONS,밀리언스,밀리언즈,밀리온스,밀리온즈
Mills => Mills,밀즈,밀스
Mind => Mind,마인드
Mind Combined => Mind Combined,MindCombined,마인드 컴바인드,마인드컴바인드
Mine => Mine,마인
Minefields => Minefields,마인필즈
minimal => minimal,미니멀
MINNY J => MINNY J,MINNYJ,소민
MINO => MINO,송민호
MINUS => MINUS,마이너스
Minute => Minute,미닛,미니트
MIRAE => MIRAE,미래,미래소년
MIROH => MIROH,미로
Mirror => Mirror,미러
misang => misang,미생
Misfit => Misfit,미스핏
Miss => Miss,미스,미쓰
miss A => miss A,missA,미쓰 에이,미쓰에이
Mistakes => Mistakes,미스테이크스
mistletoe => mistletoe,미슬토우,미쓸토우,미슬토,미쓸토
MJ => MJ,엠제이,ASTRO,아스트로
Modern => Modern,모던
Molotov => Molotov,몰로토브
Moment => Moment,모멘트,모먼트
Moments => Moments,모멘츠,모먼츠
MOMOLAND => MOMOLAND,모모랜드
Monday => Monday,먼데이
Money => Money,머니
Moneygame => Moneygame,머니게임
MONIKA => MONIKA,모니카
monkey => monkey,몽키,멍키
monla => monla,몽라
MONOPOLY => MONOPOLY,모노폴리
Monovated => Monovated,모노베이티드
Monster => Monster,몬스터
MONTERO => MONTERO,몬테로
months => months,먼스,먼쓰
mood => mood,무드
MOON => MOON,문
Moon Kim => Moon Kim,MoonKim,문 킴,문킴
MOONDANCE => MOONDANCE,문댄스
MOONLIGHT => MOONLIGHT,문라이트
Moonshot => Moonshot,문샷
More => More,모어
MORE & MORE => MORE & MORE,모어앤모어,몰앤몰
morning => morning,모닝
moss => moss,모스
Mostack => Mostack,모스택
motion => motion,모션
Motivation => Motivation,모티베이션
Motorbike => Motorbike,모터바이크
mourn => mourn,모운
Move => Move,무브
Movie => Movie,무비
moving => moving,무빙
mozyo => mozyo,모죠
Mr Eazi => Mr Eazi,Mr Eazi,미스터이지,미스터 이지
Mr. => Mr.,mister,미스터
Mr. Chu => Mr. Chu,미스터 츄,미스터 추
msftz => msftz,미스피츠
much => much,머치
Muddy Red => Muddy Red,MuddyRed,머디 레드,머디레드
MUMBLE => MUMBLE,멈블
MUSHVENOM => MUSHVENOM,머쉬베놈
my => my,마이
MYSELF => MYSELF,마이셀프
Mysterious => Mysterious,미스테리어스
N.CUS => N.CUS,NCUS,엔쿠스
N.CUS (엔쿠스) => N.CUS,엔쿠스,NCUS
N.Flying => N.Flying,NFlying,엔플라잉
NakamotoYuta => 유타,YUTA,엔씨티 127,엔씨티127,NCT 127,NCT127
Naked => Naked,네이키드
name => name,네임
Nana Rogues => Nana Rogues,NanaRogues,나나 로그스,나나로그스,나나 록스,나나록스
NAO => NAO,나오
naru => naru,나루
Nas => Nas,나스
Natalie => Natalie,나탈리
Nathan Dawe => Nathan Dawe,NathanDawe,네이선 다웨,네이선다웨
NATTY => NATTY,나띠
NATURE => NATURE,네이처
NAUNGJAE => NAUNGJAE,나웅재
NBA => NBA,엔비에이
NC 다이노스 => NC,엔씨
NCSOUND => NCSOUND,엔씨 사운드,엔씨사운드
NCT 127 => NCT 127,NCT127,엔시티 127,엔시티127
NCT 2020 => NCT 2020,NCT2020,엔씨티 2020,엔씨티2020
NCT DREAM => NCT DREAM,NCTDREAM,엔시티 드림,엔시티드림
NCT U => NCT U,NCTU,엔시티 유,엔시티유
NCT127 => NCT127,NCT 127,엔씨티 127,엔씨티127
NCTzen => NCTzen,엔시티즌,NCT 127,NCT127,엔씨티 127,엔씨티127
need => need,니드
needle => needle,니들
NELL => NELL,넬
Neo => Neo,네오
neon => neon,네온,김보경
Nerd Connection => Nerd Connection,NerdConnection,너드 커넥션,너드커넥션
nerdy => nerdy,너디,널디
Nerves => Nerves,너브스
Nervous => Nervous,널버스,너버스
Netflix => Netflix,넷플릭스
never => never,네버
NEVERMIND => NEVERMIND,네버마인드
New => New,뉴
New Hope Club => New Hope Club,NewHopeClub,뉴 호프 클럽,뉴호프클럽
New York => New York,뉴욕
next => next,넥스트
Ne-Yo => Ne-Yo,neyo,니요,네요
Niall Horan => Niall Horan,NiallHoran,나일 호런,나일호런
nice => nice,나이스
Nicki Minaj => Nicki Minaj,NickiMinaj,니키 미나즈,니키미나즈
NIDA => NIDA,니다
NIEL => NIEL,니엘
Night => Night,나이트
Night Off => Night Off,NightOff,나이트 오프,나이트오프
NIGHTMARE => NIGHTMARE,나이트메어
No Brain => No Brain,NoBrain,노브레인
NO:EL => NO:EL,NOEL,노엘
NOAH => NOAH,노아
Noah Cyrus => Noah Cyrus,NoahCyrus,노아 사이러스,노아사이러스
Nobody => Nobody,노바디
Nocturnal => Nocturnal,녹터널
Nocturne => Nocturne,녹턴
Nody Cika => Nody Cika,NodyCika,노디 시카,노디시카
NoNoNo => NoNoNo,노노노
Normal => Normal,노멀,노말
Normani => Normani,노르마니
northbutsouth => northbutsouth,노스벗사우스
Nostalgia => Nostalgia,노스텔지아
NOT => NOT,낫
Not4$ale => Not4$ale,Not 4 $ale,낫포세일,낫 포 세일
NOTD => NOTD,노티드
note => note,노트
notice => notice,노티스
November => November,노벰버
now => now,나우
NU`EST W => NU`EST W,NUESTW,뉴이스트 W,뉴이스트W
NU'EST => NU'EST,NUEST,뉴이스트
Nuka => Nuka,누카
numbers => numbers,넘버스
NYOU => NYOU,엔유
O.M.O.M => O.M.O.M,오엠오엠
O.O.O => O.O.O,OOO,오오오
O3ohn => O3ohn,오존
OASIS => OASIS,오아시스
Obliviate => Obliviate,오블리비아테
Obsession => Obsession,옵세션
ocean => ocean,오션
oceanfromtheblue => oceanfromtheblue,오션,오션프롬더블루
october => october,옥토버
ode => ode,오드
Off => Off,오프
Oh => Oh,오
OHIO => OHIO,오하이오
okay => okay,ok,오케이
old => old,올드
Older => Older,올더
Olivia O'Brien => Olivia O'Brien,OliviaOBrien,올리비아 오브라이언,올리비아오브라이언
Ombra mai fu => Ombra mai fu,Ombramaifu,옴브라 마이 푸,옴브라마이푸
OMEGA => OMEGA,오메가
OMG => OMG,oh my God,ohmyGod,오엠지
OMG What's Happening => OMG What's Happening
On => On,온
once => once,원스
one => one,원
OneRepublic => OneRepublic,원리퍼블릭
Onestep => Onestep,원스텝
ONEUS => ONEUS,원어스
ONEW => ONEW,온유
ONF => 온앤오프
only => only,온리
OnlyOneOf (KB, Love, Rie) => OnlyOneOf,KB,Love,Rie,Only One Of,온리원오브,케이비,규빈,러브,리에
OOH-AHH하게 => OOH-AHH하게,우아하게
OOMM (Out of My Mind) => OOMM (Out of My Mind)
OOPSIE => OOPSIE,웁시,웁씨
OOPSY => OOPSY,웁시,웁씨
OOSU:HAN => OOSU:HAN,OOSUHAN,우수한
OOZ => OOZ,우즈
Open => Open,오픈
Opening => Opening,오프닝
or => or,오어
orange => orange,오렌지
Orbit => Orbit,올빗
ordinary => ordinary,오디네리,오디너리
Organic => Organic,오가닉,올가닉
Orphans => Orphans,올펀스
Oscar => Oscar,오스카
Osshun Gum => Osshun Gum,OsshunGum,오션검
OST => OST,오에스티
Other => Other,아더
OuR => OuR,아월
out => out,아웃
outside => outside,아웃사이드
Outsider => Outsider,아웃사이더
over => over,오버
Overdose => Overdose,오버도스,오버도즈
Overdrive => Overdrive,오버드라이브
Overture => Overture,어버츄어,오버쳐
Ovus => Ovus,오브어스
Owell Mood => Owell Mood,OwellMood,오웰 무드,오웰무드
Ozzy Osbourne => Ozzy Osbourne,OzzyOsbourne,오지 오스본,오지오스본
P!nk => P!nk,pink,핑크
P1Harmony => P1Harmony,피원하모니
PACE => PACE,패이스
Package => Package,패키지
PADO => PADO,파도
paid => paid,페이드,패이드
pain => pain,페인
Painkiller => Painkiller,페인킬러,패인킬러
Painted÷LOVE:) => Painted÷LOVE:),페인티드러브,paintedlove
pale => pale,페일,패일
Palm Springs => Palm Springs,PalmSprings,팜 스프링스,팜스프링스
Paloma Faith => Paloma Faith,PalomaFaith,팔로마 페이스,팔로마페이스
Panic! At The Disco => Panic! At The Disco,PanicAtTheDisco,패닉엣더디스코,패닉 엣 더 디스코
Panini => Panini,파니니
Panorama => Panorama,파노라마
PAPARAZZI => PAPARAZZI,파파라치,파파라찌
Paper => Paper,페이퍼
pappuri => pappuri,파뿌리
PARACHUTE => PARACHUTE,파라슈트,패러슈트
Parade => Parade,퍼래이드
Paradigm => Paradigm,패러다임,파라다임
Paradise => Paradise,파라다이스,패러다이스
Paradox => Paradox,패러독스,파라독스
PARANOIA => PARANOIA,파라노이아
Paris => Paris,파리스,파리
parking => parking,파킹
PARKWOOJIN => PARKWOOJIN,박우진,AB6IX,에이비식스
part => part,파트
party => party,파티
Pass => Pass,패스
pat => pat,팻
PATEKO => PATEKO,파테코
Path => Path,패스
Paul Kim => Paul Kim,PaulKim,폴 킴,폴킴
paulkimV => paulkim,폴킴
Pause => Pause,포즈
Paycheck => Paycheck,페이체크,페이첵
Peach => Peach,피치
Peaches => Peaches,피치스
peanut => peanut,피넛
Pedal => Pedal,페달
Peder Elias => Peder Elias,PederElias,페더 엘리아스,페더엘리아스
PENTAGON => PENTAGON,펜타곤
Pentatonix => Pentatonix,펜타토닉스
people => people,피플
perfect => perfect,퍼팩트
Perfume => Perfume,퍼퓸
perhaps => perhaps,퍼햅스
Permission => Permission,퍼미션
Peter => Peter,피터
petty => petty,페티
pH-1 => pH-1,pH1,피에이치원
Pharrell Williams => Pharrell Williams,PharrellWilliams,퍼렐 윌리엄스,퍼렐윌리엄스
phone => phone,폰
Photo => Photo,포토
Physical => Physical,피지컬
Piano => Piano,피아노
pick => pick,픽
Picky => Picky,피키
picture => picture,픽쳐
piece => piece,피스
pillow => pillow,필로우
PiLO => PiLO,필로
PING PONG => PING PONG,PINGPONG,핑 퐁,핑퐁
pink => pink,핑크
Pink Sweat$ => Pink Sweat$,Pink Sweats,PinkSweats,핑크 스웨츠,핑크스웨츠
Pinodyne => Pinodyne,피노다인
pit => pit,핏
Pixel => Pixel,픽셀
PIXY => PIXY,픽시
Place => Place,플레이스
plastic => plastic,플라스틱
play => play,플레이
PLAYER => PLAYER,플레이어
Playlist => Playlist,플레이리스트
please => please,플레져
plogging => plogging,플로깅
Pogo => Pogo,포고
Poison => Poison,포이즌
Polaroid => Polaroid,폴라로이드
Polo G => Polo G,PoloG,폴로 지,폴로지
Ponzona => Ponzona,폰조나
POOL => POOL,풀
PoshGirls => PoshGirls,파시걸스
positions => positions,포지션스
Post Malone => Post Malone,PostMalone,포스트 멀로우니,포스트멀로우니
Potter => Potter,포터
Pouring => Pouring,포어링
pow => pow,포우,파우
Powder => Powder,파우더
Powfu => Powfu,포후
Praying => Praying,프레잉
Pre-holiday => Pre-holiday,Preholiday,프리 홀리데이,프리홀리데이
present => present,프레젠트,프레즌트
PRESENTE => PRESENTE,프레젠테
pretty => pretty,프리티
PRETTYMUCH => PRETTYMUCH,프리티머치
Primavera => Primavera,프리마베라
Princess => Princess,프린세스
PRISTIN => PRISTIN,프리스틴
probably => probably,프로바블리,프로버블리
Problems => Problems,프로블럼스
PRODUCE 48 => PRODUCE 48,PRODUCE48,프로듀스 48,프로듀스48
promise => promise,프라미스,프로미스,프라미즈,프러미즈
proof => proof,프루프
Psycho => Psycho,싸이코
Pulse => Pulse,펄스,펄쓰
pump => pump,펌프
puppy => puppy,퍼피
Purple => Purple,퍼플
PURPLE KISS => PURPLE KISS,PURPLEKISS,퍼플 키스,퍼플키스
Purple LP => Purple LP,PurpleLP,퍼플 엘피,퍼플엘피
Put => Put,풋
PUZZLE => PUZZLE,퍼즐
Q => Q,큐
Quarterback => Quarterback,쿼터백
Queen => Queen,퀸
Queendom => Queendom,퀸덤
queens => queens,퀸스,퀸즈
Quest => Quest,퀘스트
Quinn XCII => Quinn XCII,QuinnXCII,퀸 나인티투,퀸나인티투
R3HAB => R3HAB,리햅
Ra Pam Pam => Ra Pam Pam,RaPamPam,라 팜 팜,라팜팜
RADIO => RADIO,라디오,레이디오
Raedio => Raedio,레이디오
Rag'n'Bone Man => Rag'n'Bone Man,RagnBoneMan,레그 앤 본 맨,레그앤본맨
Ragoon => Ragoon,라군
Raiden => Raiden,레이든
Rain => Rain,레인
Rainbow => Rainbow,레인보우
Raissa => Raissa,레이사
Ranx => Ranx,랑크스,랭크스
RAPSTAR => RAPSTAR,랩스타
Rare => Rare,레어
Rauw Alejandro => Rauw Alejandro,RauwAlejandro,라우 알레한드로,라우알레한드로
Raye => Raye,레이
ready => ready,레디
Real => Real,리얼
Realize => Realize,리얼라이즈
Really => Really,리얼리
REBORN => REBORN,리본
Recap => Recap,리캡
records => records,레코즈
REDAY => REDAY,리데이
Redemption => Redemption,리뎀션
RED-SUN => RED-SUN,레드썬,레드선
RedVelvet => RedVelvet,레드벨벳
redyako => redyako,빨간내복야코
Reflection => Reflection,리플렉션
Refresh => Refresh,리프레쉬
Regard => Regard,리가드
Regardless => Regardless,리가드리스
Reiley => Reiley,라일리
Reintroduce => Reintroduce,리인트로듀스
RELAX => RELAX,릴렉스
Relief => Relief,릴리프
Rely => Rely,릴라이
remedy => remedy,레미디
remember => remember,리멤버
Remi Wolf => Remi Wolf,RemiWolf,레미 울프,레미울프
remind => remind,리마인드
Renegades => Renegades,레니게이즈
Rescue => Rescue,레스큐
reset => reset,리셋
Resilient => Resilient,리질리언트
RESONANCE => RESONANCE,레조넌스
REST => REST,레스트
restart => restart,리스타트
retail => retail,리테일
RETROBOT => RETROBOT,레트로봇
REVEAL => REVEAL,리빌
ReVeluv => ReVeluv,레드벨벳,Red Velvet,RedVelvet
REVERSE => REVERSE,리버스
Rex Orange County => Rex Orange County,RexOrangeCounty,렉스 오렌지 카운티,렉스오렌지카운티
Rhythm => Rhythm,리듬
riBBon => riBBon,리본
Rich => Rich,리치
Rich Brian => Rich Brian,RichBrian,리치 브라이언,리치브라이언
ride => ride,라이드
rider => rider,라이더
Ridin' => Ridin',riding,라이딩
Right => Right,라이트,롸잇,라잇
ring => ring,링
RIO => RIO,리오
Rita Ora => Rita Ora,RitaOra,리타 오라,리타오라
Ritt Momney => Ritt Momney,RittMomney,리트 몸니,리트몸니
Ritual => Ritual,리추얼
River => River,리버스
Roa => Roa,로아
Road => Road,로드
Robbie Williams => Robbie Williams,RobbieWilliams,로비 윌리엄스,로비윌리엄스
Rock `N` Roll => Rock `N` Roll Baby,RockNRollBaby,락앤롤,락 앤 롤
Rocket Punch => Rocket Punch,RocketPunch,로켓 펀치,로켓펀치
Rocking => Rocking,락킹
Rocky => Rocky,록키
Roddy Ricch => Roddy Ricch,RoddyRicch,로디 리치,로디리치
Rodeo => Rodeo,로데오
roller => roller,롤러
Rollercoaster => Rollercoaster,롤러코스터
Rollin' Rollin' => Rollin' Rollin',롤린롤린,롤링롤링
Rolling Stars => Rolling Stars,RollingStars,롤링 스타즈,롤링스타즈
Romance => Romance,로맨스
roof => roof,루프
rooftop => rooftop,루프탑
ROOKIES => ROOKIES,루키스,루키즈
Room => Room,룸
roon => roon,룬
ROSALÍA => ROSALÍA,ROSALiA,로살리아
rose => rose,로즈
Roses => Roses,로지스
ROSIE => ROSIE,로지
RUBADUM => RUBADUM,러버덤
rubberband => rubberband,러버밴드
rude => rude,루드
Rudimental => Rudimental,루디멘틀,루디멘탈
Ruel => Ruel,루엘
ruin => ruin,루인
rumors => rumors,루머스
RUN => RUN,런
Runaway => Runaway,런어웨이
running => running,러닝
Runway => Runway,런웨이
Rush => Rush,러쉬,러시
Rush Hour => Rush Hour,RushHour,러쉬 아워,러쉬아워,러시 아워,러시아워
Rxseboy => Rxseboy,로즈보이
RYEOWOOK => RYEOWOOK,려욱,슈퍼주니어,SUPER JUNIOR,SUPERJUNIOR
S.I.S => S.I.S,SIS,에스아이에스
Sabotage => Sabotage,사보타지
Sabrina Carpenter => Sabrina Carpenter,사브리나 카펜터,사브리나카펜터
Sabrina Claudio => Sabrina Claudio,SabrinaClaudio,사브리나 클라우디오,사브리나클라우디오
Sachi => Sachi,사치
sad => sad,새드
SAHARA => SAHARA,사하라
Sailing => Sailing,세일링
SakaZan => SakaZan,사카잔
salem ilese => salem ilese,salemilese,샐럼 일리스,샐럼일리스,샐럼 일리즈,샐럼일리즈
SALUTE => SALUTE,살루트,살롯
Sam Fischer => Sam Fischer,SamFischer,샘 피셔,샘피셔
Sam Ryder => Sam Ryder,SamRyder,샘라이더,샘 라이더
Sam Smith => Sam Smith,SamSmith,샘 스미스,샘스미스
SAME => SAME,세임,쎄임
Samsung => Samsung,삼성
San E => 산이,SanE,San E
San E&레이나 => San E,SanE,산이
Sandro Cavazza => Sandro Cavazza,SandroCavazza,산드로 카바자,산드로카바자
Santa => Santa,산타
Sara Kays => Sara Kays,SaraKays,사라 케이스,사라케이스
Sarah Barrios => Sarah Barrios,SarahBarrios,사라 바리오스,사라바리오스
Sarcastic Sounds => Sarcastic Sounds,SarcasticSounds,사아캐스틱 사운즈,사아캐스틱사운즈
Sasha Sloan => Sasha Sloan,SashaSloan,사샤 슬론,사샤슬론
Saturday => Saturday,세러데이,세터데이
Savage => Savage,세비지,새비지
Save => Save,세이브
Savior => Savior,세이비어
Saweetie => Saweetie,사위티
say => say,세이
Scar => Scar,스카
Scared => Scared,스케어드
Scaredy => Scaredy,스케어디
Scene => Scene,씬
scent => scent,센트
school => school,스쿨
Scream => Scream,스크림
Se.A => Se.A,SeA,세아
Sea => Sea,씨
Seal => Seal,씰
Search => Search,서치
Second => Second,세컨드
Secreto => Secreto,시크레토
Secrets => Secrets,시크릿츠
Seems  => Seems,씸스,심스
Sein => Sein,세인
Selena => Selena,셀레나
Selena Gomez => Selena Gomez,SelenaGomez,셀레나 고메즈,셀레나고메즈
selfish => selfish,셀피시,셀피쉬
Senorita => Senorita,세뇨리타,세뇨리따
sEODo => sEODo,서도
SEONGRI => SEONGRI,성리
seoul => seoul,서울
Sera => Sera,세라
Serious => Serious,시리어스
seshin => seshin,세신
set => set,셋
SEULGI => SEULGI,슬기,레드벨벳,RedVelvet
SEVENTEEN => SEVENTEEN,세븐틴
SEXY => SEXY,섹시
SF9 => SF9,에스에프나인
SG Lewis => SG Lewis,SGLewis,에스지 루이스,에스지루이스
SG워너비 => SG워너비,SG 워너비,SG WANNABE,SGWANNABE
Sha la la => Sha la la,Shalala,샤라라,샤 라 라
Shadow => Shadow,쉐도우,셰도우
SHAED => SHAED,쉐이드
Shake => Shake,쉐이크
shaker => shaker,쉐이커
Shakira => Shakira,샤키라
Shame => Shame,셰임
Shameless => Shameless,셰임리스,쉐임리스
Shampoo => Shampoo,샴푸
Shawn Mendes => Shawn Mendes,ShawnMendes,숀 멘데스,숀멘데스
she => she,쉬
Sheck Wes => Sheck Wes,SheckWes,쉑 웨스,쉑웨스
Shine => Shine,샤인
SHINee => SHINee,샤이니
Ship Wrek  => Ship Wrek,ShipWrek,쉽 렉,쉽렉
Shivers => Shivers,쉬벌스,쉬버스
shoot => shoot,슛
shop => shop,샵
shot => shot,샷
SHOULD => SHOULD,슈드
show => show,쇼
shower => shower,샤워
Shut => Shut,셧
SHUUU => SHUUU,슈
SHY => SHY,샤이
Shy Martin => Shy Martin,ShyMartin,샤이 마틴,샤이마틴
Sia => Sia,시아
SICK => SICK,식
side => side,사이드,싸이드
Sigala => Sigala,시갈라
sign => sign,사인,싸인
SIGNAL => SIGNAL,시그널,시그날,씨그널,씨그날
Silence => Silence,사일런스
Silhouette => Silhouette,실루엣
Silk City => Silk City,SilkCity,실크 시티,실크시티
Silk Sonic => Silk Sonic,SilkSonic,실크 소닉,실크소닉
Simply => Simply,심플리
Sims => Sims,심즈,심스
single => single,싱글,씽글
Singularity => Singularity,싱귤레러티,싱귤레리티,씽귤레러티,씽귤레리티
SINKING => SINKING,싱킹
SIREN => SIREN,사이렌
siwoo => siwoo,시우
SIXC => SIXC,식스크레이지,6 crazy,6crazy
Skate => Skate,스케이트
skeletons => skeletons,스켈레톤스,스켈레톤즈
Skinny Atlas => Skinny Atlas,SkinnyAtlas,스키니 아틀라스,스키니아틀라스
SKIP => SKIP,스킵
Skrillex => Skrillex,스크릴렉스
SKYFALL => SKYFALL,스카이폴
SKYLE => SKYLE,스카이리
SK나이츠 => SK나이츠,SK knights
SK텔레콤 => SK텔레콤,SKTelecom,SKT
Slack => Slack,슬랙
SLANDER => SLANDER,슬랜더
sleep => sleep,슬립
Sleeping => Sleeping,슬리핑
slide => slide,슬라이드
slime => slime,슬라임
Slom => Slom,슬롬
slow => slow,슬로우
Smackables => Smackables,스매커블스
Snapping => Snapping,스내핑
snny => snny,스니
Snoopy => Snoopy,스누피
Snowman => Snowman,스노우맨
SNUPER => SNUPER,스누퍼
snzae => snzae,선재
So => So,쏘
Sober => Sober,소버
Social House => Social House,SocialHouse,소셜 하우스,소셜하우스
SOFA => SOFA,소파
Sofia Carson => Sofia Carson,SofiaCarson,소피아 칼슨,소피아칼슨
sogumm => sogumm,소금
sokodomo => sokodomo,소코도모
SOLE => SOLE,쏠
SOLO => SOLO,솔로,쏠로
Somebody => Somebody,썸바디
Someday => Someday,썸데이
something => something,썸띵
Sometimes => Sometimes,썸타임즈
Somewhere => Somewhere,썸웨얼,썸웨어,섬웨얼,섬웨어
SOMYA => SOMYA,소먀
Sonamoo => Sonamoo,소나무
Sondia => Sondia,손디아
song => song,송,쏭
soon => soon,순,쑨
SOOYOUNG => SOOYOUNG,수영,소녀시대
Sophia Messa => Sophia Messa,SophiaMessa,소피아 메사,소피아메사
Sophia Somajo => Sophia Somajo,SophiaSomajo,소피아 소마조,소피아소마조
SoRi => SoRi,소리
Sorry => Sorry,쏘리
SOSO => SOSO,소소,쏘쏘
soul => soul,소울,쏘울
Soul (Superorganism) => Soul,소울
Sound by KONA => KONA,코나
Soup => Soup,수프,숲,숩
sourlmate => sourlmate,소울메이트,쏘울메이트
south => south,사우스,싸우스
Spare => Spare,스페어
SPARKY => SPARKY,스파키
Special => Special,스페셜
Speechless => Speechless,스피치리스
SPIN OFF => SPIN OFF,SPINOFF,스핀오프,스핀 오프
Spirits => Spirits,스피릿츠
spit => spit,스핏
Splash => Splash,스플래쉬
Spoiled => Spoiled,스포일드
spot => spot,스팟,스폿
Spotlight => Spotlight,스포트라이트
spring => spring,스프링
SSG 랜더스 => SSG,에스에스지
Stack => Stack,스택
STALKER => STALKER,스토커
Stand => Stand,스탠드
Standard1 => Standard1,스탠다드원
star => star,스타
STARLIGHT => STARLIGHT,스타라이트
Starry => Starry,스타리
Starstruck => Starstruck,스타스트럭
start => start,스타트
Starter => Starter,스타터
Stay => Stay,스테이
Steal => Steal,스틸
Stealer => Stealer,스틸러
Steam => Steam,스팀
Stefflon Don => Stefflon Don,StefflonDon,스테플론 던,스테플론던
step => step,스텝
Stephanie Poetri => Stephanie Poetri,StephaniePoetri,스테파니 도허티,스테파니도허티
Steve Aoki => Steve Aoki,SteveAoki,스티브 아오키,스티브아오키
Sticker => Sticker,스티커
still => still,스틸러
stop => stop,스탑,스톱
storm => storm,스톰
Stormzy => Stormzy,스톰지
Story => Story,스토리
Straight No Chaser => Straight No Chaser,StraightNoChaser,스트레이트 노 체이서,스트레이트노체이서
Strange => Strange,스트레인지
stranger => stranger,스트레인저
Strawberry => Strawberry,스트로베리
streets => streets,스트리츠,스트릿츠
Stronger => Stronger,스트롱거
Stuck => Stuck,스턱
STUDIO CHOOM => STUDIO CHOOM,STUDIOCHOOM,스튜디오 춤,스튜디오춤
Studio EIM => Studio EIM,StudioEIM,스튜디오 EIM,스튜디오EIM,스튜디오 이아이엠,스튜디오이아이엠
stupid => stupid,스투피드
Sucker => Sucker,서커
sucks => sucks,썩스
Suga Mama => Suga Mama,슈가맘마
Sugar => Sugar,슈가
SugarCrash => SugarCrash,슈가크래시
Suitcase => Suitcase,수트케이스
Suji => Suji,수지
SUMIN => SUMIN,수민
Summer => Summer,써머,서머
Summer Soul => Summer Soul,SummerSoul,썸머 소울,썸머소울
Summer Walker => Summer Walker,SummerWalker,서머워커,서머 워커
summertime => Summertime,썸머타임,써머타임
SummerWish => SummerWish,썸머위시
sun => sun,썬,선
sunbeam => sunbeam,선번,썬번
Sundae => Sundae,선데
Sundara Karma => Sundara Karma,SundaraKarma,선다라 카르마,선다라카르마
Sunday => Sunday,선데이,썬데이
Sunday Moon => Sunday Moon,SundayMoon,선데이 문,선데이문
Sunflower => Sunflower,선플라워,썬플라워
SUNG-AH => SUNG-AH,SUNGAH,성아
sunmi => sunmi,선미
Sunny => Sunny,서니,써니
Sunset => Sunset,선셋,썬셋,썬쎗
Sunshine => Sunshine,썬샤인,선샤인
Sunshiny => Sunshiny,썬샤이니,선샤이니
SUPADUPA => SUPADUPA,수파두파
Supalonely => Supalonely,슈퍼론리
super => super,수퍼
SUPER JUNIOR => SUPER JUNIOR,SUPERJUNIOR,슈퍼 주니어,슈퍼주니어,슈주
SUPER JUNIOR-D&E => SUPER JUNIOR,슈퍼주니어
supercuts => supercuts,슈퍼컷츠
Superfruit => Superfruit,Super fruit,수퍼 프루트,수퍼프루트
SuperM => SuperM,슈퍼엠
Superman => Superman,슈퍼맨
SUPERNOVA => SUPERNOVA,슈퍼노바
surf => surf,서프
Surfaces => Surfaces,서피시스
Surprise => Surprise,서프라이즈
SUZY => SUZY,수지
Swae Lee => Swae Lee,SwaeLee,스웨 리,스웨리
Swagga x Wagga => Swagga x Wagga,Swagga Wagga,SwaggaWagga,스웨거 웨거,스웨거웨거
Swan => Swan,스완
Swear => Swear,스웨어
Sweet => Sweet,스위트
Sweety => Sweety,스위티
Swervy => Swervy,스윌비
swimming => swimming,스위밍
SWIPE => SWIPE,스와이프
Syd => Syd,시드
Sylo Nozra => Sylo Nozra,SyloNozra,사일로 노즈라,사일로노즈라
SZA => SZA,시저
TAEIL => TAEIL,태일,NCT 127,NCT127,엔씨티 127,엔씨티127,NCT
TAEMIN => TAEMIN,태민,샤이니,SHINee
taessl => taessl,태쓸
TAEYANG => TAEYANG,태양
TAEYONG => TAEYONG,태용,엔씨티 127,NCT 127
TAEYOON => TAEYOON,태윤
TAEYOUNG => TAEYOUNG,태용,엔씨티 127,엔씨티127,NCT 127,NCT127
Tag => Tag,태그
Tainy => Tainy,타이니
take => take,테이크
Takeaway => Takeaway,테이크어웨이
taken => taken,테이큰
Taki Taki => Taki Taki,TakiTaki,타키타키,타키 타키
Taking => Taking,테이킹
Tale => Tale,테일
Talk => Talk,토크
Tamed-Dashed => Tamed-Dashed,TamedDashed,태임드 대시드,태임드대시드
Tango => Tango,탱고
Tank => Tank,탱크
T-ara => T-ara,Tara,티아라
tarot => tarot,타로
Taste => Taste,테이스트
Tate McRae => Tate McRae,TateMcRae,테이트 맥레이,테이트맥레이
Tattoos => Tattoos,타투
Tayo => Tayo,타요
Tayo Sound => Tayo Sound,TayoSound,타요 사운드,타요사운드
teacher => teacher,티쳐
TEAMO => TEAMO,띠아모
Tear => Tear,티어
Tears => Tears,티어스
teddy => teddy,테디
Teeth => Teeth,티쓰
Telepathy => Telepathy,텔레파시
telepatía => telepatía,텔레파티아
Tell => Tell,텔
teller => teller,텔러
Tempest => Tempest,템페스트
Tempo => Tempo,템포
Tequila => Tequila,테킬라
TESSERACT => TESSERACT,테저렉
text => text,텍스트
THAMA => THAMA,따마
Than => Than,댄
THANKFUL => THANKFUL,땡크풀
THANXX => THANXX,땡쓰,땡스
that => that,댓
The => The,더,디
The Chainsmokers => The Chainsmokers,더 체인스모커스
The High Note => The High Note,TheHighNote,더 하이 노트,더하이노트
The Kid LAROI => The Kid LAROI,TheKidLAROI,더 키드 라로이,더키드라로이
The Quiett => The Quiett,TheQuiett,더 콰이엇,더콰이엇
THE SCOTTS => THE SCOTTS,THESCOTTS,더 스캇츠,더스캇츠
The Script => The Script,TheScript,더 스크립트
The Strokes => The Strokes,TheStrokes,스트록스
The Wailers => The Wailers,TheWailers,더월러스,더 월러스,월러스,더 웨일러스,더웨일러스
The Weeknd => The Weeknd,TheWeeknd,위켄드
THEATRE => THEATRE,시어터
therapy => therapy,테라피,떼라피
there => there,데어,데얼
Therefore => Therefore,데어포어
THEY. => THEY.,데이
thing => thing,띵
Things => Things,띵스
this => this,디스
Thousand => Thousand,사우전드,싸우전드
THRILL => THRILL,쓰릴
through => through,thru,쓰루
Thru => Thru,쓰루,through
Thumbs => Thumbs,떰즈,썸즈
Thunderclouds => Thunderclouds,썬더클라우즈
TIAMO => TIAMO,티아모,띠아모
Tick Tock => Tick Tock,틱톡
Tied => Tied,타이드
Tiësto => Tiësto,Tiesto,티에스토
Tifa Chen => Tifa Chen,TifaChen,티파첸,티파 첸
tiger => tiger,타이터
Tiger JK => Tiger JK,TigerJK,타이거 JK,타이거JK,타이거 제이케이,타이거제이케이
Tight => Tight,타이트,타잇
Tiki-Taka => Tiki-Taka,티키타카
TikTok => TikTok,틱톡
time => time,타임
Timeless => Timeless,타임리스,타임레스
Timing => Timing,타이밍
Tinashe => Tinashe,티나세
tired => tired,타이어드
TITANIC => TITANIC,타이타닉
TJ => TJ,티제이
TMI => TMI,티엠아이
TO => TO,투
Toc Toc Toc => Toc Toc Toc,톡톡톡
Today => Today,투데이
Together => Together,투게더
Tom Grennan => Tom Grennan,TomGrennan,톰 그래넌,톰그래넌
Tomine Harket => Tomine Harket,TomineHarket,토미니 하켓,토미니하켓
TOMMY YANG => TOMMY YANG,TOMMYYANG,토미양,토미 양,타미양
tomorrow => tomorrow,투모로우
TOMTOMI => TOMTOMI,톰토미
Tones And I => Tones And I,TonesAndI,톤즈 앤 아이,톤즈앤아이
Tongue => Tongue,텅
tonight => tonight,투나이트,투나잇
too => too,투
Toosie => Toosie Slide,ToosieSlide,투지슬라이드,투지 슬라이드
TOOTIMETOOTIMETOOTIME => TOOTIMETOOTIMETOOTIME,투타임투타임투타임
Top => Top,탑,톱
Topic => Topic,토픽
Torn => Torn,톤
total => total,토탈,토털
TOUCH => TOUCH,터치
TOUT Y EST => TOUT Y EST,TOUTYEST,투티에
town => town,타운
Toy => Toy,토이
track => track,트랙
Train => Train,트레인
Trampoline => Trampoline,트램폴린.트램펄린
Travis Barker => Travis Barker,TravisBarker,트라비스바커,트라비스 바커
Travis Scott => Travis Scott,TravisScott,트래비스 스콧,트래비스스콧
treasure => treasure,트레져
treat => treat,트리트,트릿
tree => tree,트리
TREND => TREND,트렌드
TRIANGLE => TRIANGLE,트라이앵글
trick => trick,트릭
TRIGGER => TRIGGER,트리거
Triggered => Triggered,트리거드
trip => trip,트립
trouble => trouble,트러블
Troye Sivan => Troye Sivan,TroyeSivan트로이 시반,트로이시반
Truedy => Truedy,트루디
TRUST => TRUST,트러스트
T-Shirts => T-Shirts,TShirts,티셔츠
TT => TT,티티
Tungevaag => Tungevaag,퉁게박
turn => turn,턴
Tusa => Tusa,투사
TV => TV,티비
Twenty => Twenty,트웬티
Twenty One Pilots => Twenty One Pilots,TwentyOnePilots,21파일롯,21pilots,21 pilots
TWICE => TWICE,트와이스
TWILIGHT => TWILIGHT,트와일라잇
Twin => Twin,트윈
twist => twist,트위스트
Ty Dolla $ign => Ty Dolla $ign,TyDolla$ign,타이 달라 사인,타이 달라 사인
Tyga => Tyga,타이가
Tyler, The Creator => Tyler,타일러,The Creator,TheCreator,더 크리에이터,더크리에이터
U Hoo Hoo => U Hoo Hoo,UHooHoo,유 후 후,유후후
UGLY => UGLY,어글리
Uh-Oh => Uh-Oh,어오
uju => uju,우주
U-Kiss => U-Kiss,Ukiss,유키스
U-KNOW => U-KNOW,UKNOW,유노윤호
UMI => UMI,우미
UN DIA => UN DIA,UNDIA,운 디아,운디아
Undecided => Undecided,언디사이디드
under => under,언더
Underdog => Underdog,언더독
underneath => underneath,언더니스
underrock => underrock,언더락,언더록
universe => universe,유니버스,유니벌스
Unknown => Unknown,언노운
Unlearn => Unlearn,언런
UNNATURAL => UNNATURAL,언내츄럴
Unsung => Unsung,언성,언썽
Until => Until,언틸
Up => Up,업
Up Star => Up Star,UpStar,업 스타,업스타
UP10TION => UP10TION,업텐션
UPSAHL => UPSAHL,업살,캐머런 업살,테일러 캐머런 업살,캐머런업살,테일러캐머런업살
Us => Us,어스
used => used,유즈드
Usher => Usher,어셔
UTOPIA => UTOPIA,유토피아
UV => UV,유브이
V => V,뷔
V.O.S. => V.O.S.,브이오에스
Vacation => Vacation,베케이션
Valentine => Valentine,발렌타인
VAMOS => VAMOS,바모스
Vampire => Vampire,뱀파이어
VAN.C => VAN.C,VANC,밴씨
Vance Joy => Vance Joy,VanceJoy,밴스 조이,밴스조이,반스 조이,반스조이
Vanilla => Vanilla,바닐라
VanJess => VanJess,반제스
vaultboy => vaultboy,vault boy,볼트보이,볼트 보이
Vcoloring => Vcoloring,V컬러링
VEAUTIFUL BIEW => VEAUTIFUL BIEW,VEAUTIFULBIEW,뷰티풀 뷰,뷰티풀뷰
Vegas => Vegas,베가스
VERIVERY => VERIVERY,베리베리
Vibes => Vibes,바이브스
Vibez => Vibez,바이브즈
Vibin => Vibin,비빈
Victoria Monèt => Victoria Monèt,,VictoriaMonèt,,Victoria Monet,,VictoriaMonet,빅토리아 모네,빅토리아모네
View => View,뷰
Villain => Villain,빌런
vintage => vintage,빈티지
VIOLET => VIOLET,바이올렛
Violin => Violin,바이올린
Viral Affair => Viral Affair,ViralAffair,바이럴 어페어,바이럴어페어
Virginia To Vegas => Virginia To Vegas,VirginiaToVegas,버지니아 투 베가스,버지니아투베가스
VIVACE => VIVACE,비바체
ViViD => ViViD,비비드
VIZE => VIZE,비제
voice => voice,보이스
Volume => Volume,볼륨
V컬러링레전드 => 레전드,legend
Waiting => Waiting,웨이팅
Waits => Waits,웨이츠
wake => wake,웨이크
walk => walk,워크
WALKER => WALKER,워커
Walking => Walking,워킹
wall => wall,월
Wallows => Wallows,왈로우즈
Wallpaper => Wallpaper,월페이퍼
Waltz => Waltz,월츠
WANNA => WANNA,워너
WANNABE => WANNABE,워너비
Wanted => Wanted,원티드
war => war,워
warm => warm,웜
Warning => Warning,워닝
WARTIME => WARTIME,워타임
Was => Was,워즈
Waste => Waste,웨이스트
water => water,워터
Waterfalls => Waterfalls,워터폴
Watermelon => Watermelon,워터멜론
WATTS => WATTS,와츠
Wave => Wave,웨이브
Waveon Coffee => Waveon Coffee,WaveonCoffee,웨이브온 커피,웨이브온커피
Waves => Waves,웨이브스
wavve => wavve,웨이브
Wavycake => Wavycake,웨이비케이크
WAX => WAX,왁스
Way => Way,웨이
We => We,위
We all lie => We all lie,Wealllie,위 올 라이,위올라이
Weak => Weak,윅,위크
weather => weather,웨더
wedding => wedding,웨딩
WEE WOO => WEE WOO,WEEWOO,위 우,위우
WEEKDAY => WEEKDAY,위크데이
WEEKEND => WEEKEND,위켄드
Weekly => Weekly,위클리
WEi => Wei,위아이
Weki Meki => Weki Meki,WekiMeki,위키 미키,위키미키
Welcome => Welcome,웰컴
WENDY => WENDY,웬디,레드벨벳,Red Velvet,RedVelvet
West => West,웨스트
WE-YOU => WE-YOU,WEYOU,WE YOU,위유,위 유
Whale => Whale,웨일
Wham! => Wham!,Wham,왬,웸
What => What,왓
what2do => what2do,왓투두,왓 투 두
WHATEVER => WHATEVER,왓에버
Whee In => Whee In,WheeIn,휘인
Wheel => Wheel,휠
wheels => wheels,휠스
When => When,웬
WHENEVER => WHENEVER,웬에버
white => white,화이트
Whitney Houston => Whitney Houston,WhitneyHouston,휘트니 휴스톤,휘트니휴스톤
who => who,후
Who Dat B => Who Dat B,WhoDatB,후 댓 비,후댓비
why => why,와이
Why Don't We => Why Don't We,WhyDontWe,와이 돈 위,와이돈위
Wiener Philharmoniker => Wiener Philharmoniker,WienerPhilharmoniker,빈 필하모니 관현악단
wife => wife,와이프
Wild => Wild,와일드
Willow Sage Hart => Willow Sage Hart,WillowSageHart,윌로우 세이지 하트,윌로우세이지하트
WILRO => WILRO,윌로
wind => wind,윈디
window => window,원도우
Windy => Windy,윈디
Wings => Wings,윙스,윙즈
WINNER => WINNER,위너
Winners => Winners,위너스
Wire => Wire,와이어
wish => wish,위시
with => with,위드
without => without,위드아웃,위다웃
withus => withus,위더스
Wiz Khalifa => Wiz Khalifa,WizKhalifa,위즈 칼리파,위즈칼리파
Woman => Woman,우먼
Wonder => Wonder,원더
Wonderful => Wonderful,원더풀
WONDERLAND => WONDERLAND,원더랜드
WONHO => WONHO,원호
Woods => Woods,우즈
WOODZ => WOODZ,우즈
WOOJAE => WOOJAE,우재
Word => Word,워드
work => work,워크
world => world,월드
Worry => Worry,워리
Worse => Worse,월스
worst => worst,워스트,월스트
worth => worth,월쓰
WoW => WoW,와우
wrap => wrap,랩
writing => writing,라이팅
wrong => wrong,롱
X.Q => X.Q,XQ,엑스큐
Xani => Xani,산희
XIA => XIA,시아
XIMON => XIMON,시몬
XIUMIN => XIUMIN,시우민,엑소,EXO
xmas => xmas,X-Mas,엑스마스,christmas,크리스마스
XOXO => XOXO,엑스오엑스오
XRO => XRO,재로
Xtra => Xtra,엑스트라
XXHOLIC => XXHOLIC,엑스엑스홀릭,엑스엑스 홀릭
Y => Y,와이
Y2K => Y2K,와이투케이
YACHT => YACHT,요트
Years & Years => Years&Years,이어즈앤이어즈,이어즈 앤 이어즈
YEGNY => YEGNY,최예근
yellow => yellow,엘로우
Yellow Cab => Yellow Cab,YellowCab,옐로우캡,옐로우 캡
Yeouido => Yeouido,여의도
YERI => YERI,예리
YES => YES,예스
YES or YES => YES or YES,예스 오어 예스,예스오예스
YESEO => YESEO,예서
YESSIR => YESSIR,에써
Yesterday => Yesterday,예스터데이
Yet => Yet,옛
YEWON => YEWON,예원
yey => yey,예이
YOLO => YOLO,욜로
YonYon => YonYon,욘욘
YOSEMITE => YOSEMITE,요새미티
YOU => YOU,유
young => young,영
Young Adz => Young Adz,YoungAdz,영애즈,영 애즈
Young Do => Young Do,YoungDo,영도
Young K => Young K,YoungK,영 케이,영케이
Young Thug => Young Thug,YoungThug,영 서그,영서그,영떠그,영 떠그
Younger => Younger,영거
Youngjae => Youngjae,영재
YoungK => YoungK,영케이,DAY6,데이식스
your => your,유어,유얼
you're => you're,유얼,유아
Yours => Yours,유얼스,유어스
Yourself => Yourself,유어셀프
Youth => Youth,유스,유쓰
Yo-Yo Ma => Yo-Yo Ma,YoYo Ma,YoYoMa,요요마
YUGYEOM => YUGYEOM,유겸
YUMI => YUMI,유미
Yummy => Yummy,여미
YUN => YUN,윤
Yuna => Yuna,유나
YunaKim => YunaKim,김연아
Yung Bae => Yung Bae,YungBae,영 배,영배
YUNGBLUD => YUNGBLUD,영블러드
YUTA => YUTA,유타,NCT 127,NCT127,엔씨티 127,엔씨티127,NCT
Z.flat => Z.flat,Zflat,지플랫
Zag => Zag,재그
Zara Larsson => Zara Larsson,ZaraLarsson,자라 라슨,자라라슨
ZAYN => ZAYN,제인
ZAZA => ZAZA,자자
Zedd => Zedd,제드
Zeenan => Zeenan,정진환
ZERO => ZERO,제로
ZGZG => ZGZG,지기지기
Zig => Zig,지그
Zion.T => Zion.TZionT,자이언티
Zombie => Zombie,좀비
ZZZ => ZZZ,지지지
가을 => 가을,autumn,fall
감옥펭 => 감옥펭,펭수
강아지 => 강아지,dog,puppy 
게임 => 게임,game
겨울 => 겨울,winter
겨울_발라드의_왕이다 => 겨울_발라드의_왕이다
고양이 => 고양이,cat
골프 => 골프,golf
구름 => 구름,cloud
군인 => 군인,soldier
기다림펭 => 기다림펭,펭수
농구 => 농구,baseketball
뉴에이지 => 뉴에이지,New Age,NewAge
뉴키드 => 뉴키드,Newkidd
독립,만18세 => 독립,만18세,독립만18세
다이나믹 듀오 => 다이나믹 듀오,다이나믹듀오,Dynamicduo,다듀
다이어트 => 다이어트,Diet
달 => 달,moon
대표펭 => 대표펭,펭수
댄스 => 댄스,dance
댄스 락 => 댄스 락,댄스락,dance rock,dancerock
댄스 팝 => 댄스 팝,댄스팝,dance pop,dancepop
댄스팝 => 댄스팝,댄스 팝,dance pop,dancepop
댄싱머신 => 댄싱머신,dancing machine
도시 => 도시,city
드라마 => 드라마,drama
디스코 => 디스코,disco
디에잇 => 디에잇,THE 8,THE8
딘딘 => 딘딘,DinDin
라틴 팝 => 라틴 팝,라틴팝,Latin pop,Latinpop
라틴댄스 => 라틴댄스,latin dance
라포엠 => 라포엠,LA POEM,LAPOEM
라피나 앤 캐비 => 라피나 앤 캐비,라피나앤캐비,Raffina & Cavi,Raffina&Cavi
락 => 락,Rock,록
락 발라드 => 락 발라드,락발라드,Rock ballade,Rockballade,록 발라드,록발라드
랩 => 랩,rap
랩 발라드 => 랩 발라드,랩발라드,Rap Ballad,RapBallad
러블리즈 => 러블리즈,lovelyz
레게 => 레게,reggae
레인보우 => 레인보우,RAINBOW
레트로 => 레트로,Retro
레트로썸머MV => 레트로썸머MV,레트로 썸머 MV,retro summer MV,retrosummerMV
로꼬 => 로꼬,LOCO
로즈데이 => 로즈데이,ROES DAY,ROSEDAY
마틴스미스 => 마틴스미스,마틴 스미스,Martin Smith,MartinSmith
메타버스 => 메타버스,Metaverse
모던 락 => 모던 락,모던락,Modern rock,Modernrock,모던 록,모던록
몬스타엑스 => 몬스타엑스,몬스타 엑스,MONSTA X,MONSTAX
뮤직비디오 => 뮤직비디오,music video,musicvideo,뮤비,MV
미디어아트 => 미디어아트,미디어 아트,media art,mediaart
미스터트롯 => 미스터트롯,Mr.트롯
바다 => 바다,sea,ocean
바캉스 => 바캉스,vacance
박진영 => 박진영,JYP
발라드 => 발라드,ballade
발렌타인데이 => 발렌타인데이,valentine's day
방탄소년단 => 방탄소년단,BTS
버섯 => 버섯,mushroom
버스킹 => 버스킹,busking
버즈 => 버즈,Buzz
벤 => 벤,BEN
별 => 별,star
봄 => 봄,spring
브라운 아이드 소울 => 브라운 아이드 소울,브라운아이드소울,Brown Eyed Soul,BrownEyedSoul,브아솔
블록버스터_뮤우직비디오 => 블록버스터_뮤우직비디오
블루 => 블루,blue
비 => 비,Rain
비투비 => 비투비,BTOB
비투비 포유 => 비투비 포유,비투비포유,BTOB 4U,BTOB4U
비트 => 비트,Beat
빈센트블루 => 빈센트블루,빈센트 블루,Vincent Blue,VincentBlue
빈첸 => 빈첸,VINXEN
사랑 => 사랑,love
사자펭 => 사자펭,펭수
상담원펭 => 상담원펭,펭수
새해 => 새해,new year
새해펭수 => 새해펭수,펭수
선글라스 => 선글라스,sunglass
셀럽 => 셀럽,celebrity
소울 => 소울,soul
소프트 락 => 소프트 락,소프트락,soft rock,softrock,소프트 록,소프트록
솔로 => 솔로,SOLO
쇼퍼홀릭 => 쇼퍼홀릭,Shopaholic
숲 => 숲,forest
스윙스 => 스윙스,Swings
스트릿우먼파이터 => 스트릿우먼파이터,스우파
스포츠 => 스포츠,sports
슬기로운 의사생활 => 슬기로운 의사생활,슬기로운의사생활,슬의생,슬기로운 의사생활 시즌2
시즈널 => 시즈널,seasonal
시티팝 => 시티팝,citypop
神메뉴 => 神메뉴,신메뉴
신스 팝 => 신스 팝,신스팝,Synth Pop,SynthPop
심플 => 심플,simple
싱어게인 => 싱어게인,Singagain
싱포유 => 싱포유,Sing For You,SingForYou
아기 => 아기,baby 
아웃렛 => 아웃렛,OUTLET
아웃사이더 => 아웃사이더,Outsider
아이덴티티 => 아이덴티티,Identity
아이돌 => 아이돌,idol
악동뮤지션 => 악동뮤지션,AKMU,악뮤
알앤비 => 알앤비,R&B
애니메이션 => 애니메이션,animation
앤씨아 => 앤씨아,NC.A,NCA
야구 => 야구,baseball
어쿠스틱 팝 => 어쿠스틱 팝,어쿠스틱팝,Acoustic pop,Acousticpop
언택트 => 언택트,Untact
얼터너티브 락 => 얼터너티브 락,얼터너티브락,alternative rock,alternativerock,얼터너티브 록,얼터너티브록
얼터너티브 팝 => 얼터너티브 팝,얼터너티브팝,Alternative Pop,AlternativePop 
에미넴 => 에미넴,Eminem
에쓰오일 => 에쓰오일,S오일,S-oil
여름 => 여름,summer
영화 => 영화,movie
요가 => 요가,yoga
우주소녀 => 우주소녀,WJSN
워너원 => 워너원,Wanna One,WannaOne
원슈타인 => 원슈타인,Wonstein
월드뮤직 => 월드뮤직,World Music,WorldMusic
웹툰 => 웹툰,Webtoon
위키미키 => 위키미키,Weki Meki,WekiMeki
유니세프 => 유니세프,unicef
유럽 => 유럽,Europe
유머 => 유머,humour
음식 => 음식,food
음악 => 음악,music
이지 리스닝 (뉴에이지) => 이지,easy,리스닝,listening,뉴에이지,NewAge
인디 락 => 인디 락,indi rock
인디 일렉트로닉 => 인디 일렉트로닉,인디일렉트로닉,Indie Electronic,IndieElectronic
인디 팝 => 인디 팝,인디팝,indie pop,indiepop
일러스트 => 일러스트,illust
일렉트로 팝 => 일렉트로 랍,일렉트로팝,Electro Pop,ElectroPop
일렉트로닉 => 일렉트로닉,electronic
일렉트로닉 팝 => 일렉트로닉 팝,일렉트로닉팝,electronic pop,electronicpop
자동차 => 자동차,car
자연 => 자연,nature
재즈 => 재즈,jazz
전화걸어V챌린지 => 챌린지,challenge
제국의아이들 => 제국의아이들,제아,ZE:A
제주 => 제주,jeju
조이 => 조이,joy
초콜릿 => 초콜릿,chocolate
추억 => 추억,memory
치즈 => 치즈,CHEEZE
카운트다운 => 카운트다운,Countdown
캐릭터 => 캐릭터,character
캠페인 => 캠페인,campaign
커플 => 커플,couple
커피 => 커피,Coffee
컨트리 => 컨트리,country
코로나 => 코로나,covid19
코미디 => 코미디,comedy
코믹 => 코믹,comic
퀴즈 => 퀴즈,Quiz
크로스오버 => 크로스오버,crossover
크리에이터 => 크리에이터,Creator
클래식 => 클래식,classic
키즈 => 키즈,Kids
탱고 => 탱고,tango
테크놀로지 => 테크놀로지,technology
투모로우바이투게더 => 투모로우바이투게더,tomorrow X together,TXT,투바투
트로트 => 트로트,trot
틴 팝 => 틴 팝,틴팝,teen pop,teenpop
팝 => 팝,pop
팝 락 => 팝 락,팝락,pop rock,poprock
팝송 => 팝송,popsong,pop song,팝,pop
패러디 => 패러디,parady
펭수 => 펭수,pengsoo,GP
포크 => 포크,folk
포크 팝 => 포크 팝,포크팝,folk pop,folkpop
포크팝 => 포크팝,포크 팝,folk pop,folkpop
폭탄 => 폭탄,bomb
풍선 => 풍선,balloon
프렌치 팝 => 프렌치 팝,프렌치팝,French Pop,FrenchPop
프로미스나인 => 프로미스나인,fromis9,fromis 9
플라이 투 더 스카이 => 플라이 투 더 스카이,플라이투더스카이,FLY TO THE SKY,FLYTOTHESKY
피크닉 => 피크닉,picnic
하늘 => 하늘,sky
하우스 => 하우스,House
하이라이트 => 하이라이트,Highlight
하트 => 하트,heart
하트펭수 => 하트펭수,펭수
한가위 => 한가위,추석
한국 => 한국,대한민국,korea
할로윈 => 할로윈,Halloween
행운 => 행운,fortune
헬스 => 헬스,health
호수 => 호수,lake
홈트 => 홈트,hometraining,홈트레이닝
힙합 => 힙합,hip hop
힙합 소울 => 힙합 소울,힙합소울,Hiphop Soul,HiphopSoul
FALSE => FALSE,폴스
